30 100
ACGCACGCTGCACTCACATGATCTCATCTT|TTCTGGCGTCGTTTGGCAGGTCGGGGTTCA
CGTTTGGCAGGTCGGGGTTCACTGGCCTGT|GCATCTTACCAAATTCGAGTTAATAAGATG
ATGGCAAGGATGTCGTGTACTGTGAATGGG|CGTTCTGTGGTCGGAGCTCAAGGGCAAATA
TGATGGCAAGGATGTCGTGTACTGTGAATG|GACGTTCTGTGGTCGGAGCTCAAGGGCAAA
CGGGTGGGCACTACTGTGAATGGGTGGAGC|ATGGGTGGAGCGGGTGGGCACGGCCCGAGC
CTTTGTGGAAGTTCCACGAGATGCATCAGG|TCACTGGCCTGTACTGTGAATGGGTGGAGC
GAAAGTGGTTCTGGCGTCGTTTGGCAGGTC|CCATTCGCAGTTTTTTCGCATCTTACCAAA
CACGGCTAATACTGTGAATGGGTGGAGCGG|ACTCGAACGTATGCTGTCAGTACTGTGAAT
GCAGTTTGCAGTGGGGGCCTAGGCCCCGGC|AGCGCGTCTACTCTTAGTTAAATGGGATCG
TTGTGGCCAGACCCAAAACACTCCCAAGCT|CTCTATCATGTAATTAACCCTGTAAATACC
TCACGGCTAATACTGTGAATGGGTGGAGCG|GACTCGAACGTATGCTGTCAGTACTGTGAA
TGCTGTCAGTACTGTGAATGGGTGGAGCGG|GGAATTGGTTCACTGGTCTCTTATAGGACT
ATGTCGAGACCTTACTGTGAATGGGTGGAG|AGATGCCGGAGACCGTCTGTATACAGCTTA
GCGTCGTTTGGCAGGTCGGGGTTCACTGGC|TTTCGCATCTTACCAAATTCGAGTTAATAA
GGCAAATATCACTGATCCTAACTGAGCGCT|GTGAATGGGTGGAGCGGGTGGGCACGCAGA
TTTCGTGAACCTCAAGTAGGAGTGAAAAGG|ATCAGTTAGTACTGTGAATGGGTGGAGCGG
CGCAGATAGGCTACTGTGCGTATATGCGTG|ATGGACGCCCACTCGACCCGGCGGGGACCA
GACGTTCTGTGGTCGGAGCTCAAGGGCAAA|GCTGTGTTCACACCTGTCTTTACTGTGAAT
ACCGTGAGTACTGTGAATGGGTGGAGCGGG|TGGGATGTCGCTGAGCAACACGTCAGTTAG
TGCATCAGGGCAACACAAGATGCCGGAGAC|GGGTGGAGCGGGTGGGCACGCTTGCGTCTT
CACACGCAACTATGGACCAAACCATTCGCA|ATGGGTGGAGCGGGTGGGCACGGGCACGCT
CCGAAATTAAATACAGTTGTGGCCAGACCC|GACGTACCCCGTGCTGCTCTATCATGTAAT
CGTGCTGCTCTATCATGTAATTAACCCTGT|GTGGAGCGGGTGGGTACTGTGAATGGGTGG
GTTGGGCACACGCAACTATGGACCAAACCA|CTGTGAATGGGTGGAGCGGGTGGGCACGGG
ACCGTCTGTATACAGCTTACTGTGAATGGG|TTGACTCACAGAACCGTTAGTTGGGCACAC
CTGTGAATGGGTGGAGCGGGTGGGCACGAC|CCCCGGCCGGTCGTCTTTTTGGGTGCGGCT
ACGACGTTCTGTGGTCGGAGCTCAAGGGCA|CGGCTGTGTTCACACCTGTCTTTACTGTGA
ATGGTCTATCAGTTAGTACTGTGAATGGGT|TTGCAGTGGGGGCCTAGGCCCCGGCCGGTC
AACTGGTCGGATATAGACTACTTACTGTGA|CGTCGAGGAGGAGCACCGGGCATTTAATGA
GGGTGGAGCGGGTGGGCACGGGCACGCTAC|GGCCCGAGCGCCCCGCGGAACAACTCCACA
TGTGAATGGGTGGAGCGGGTGGGCACGAAA|TTGGGCACACGCAACTATGGACCAAACCAT
GCGCCCCGCGGAACAACTCCACATGCCCGT|TCAATTAGCGGAACGTCCTAAGCCTGCAGT
AAATACAGTTGTGGCCAGACCCAAAACACT|CCGTGCTGCTCTATCATGTAATTAACCCTG
CTTTTTGGGTGCGGCTGTGTTCACACCTGT|CACGGCTAATACTGTGAATGGGTGGAGCGG
TGGGTGGAGCGGGTGGGCACGACGTACCCC|GATATATGTCGAGACCTTACTGTGAATGGG
GTGGAGCGGGTGGGCACGGCCCGAGCGCCC|ATCACTGATCCTAACTGAGCGCTGTCAATT
CGCTGTCGTCGAGGAGGAGCACCGGGCATT|GGCACGCACGCTGCACTCACATGATCTCAT
TGGCCAGACCCAAAACACTCCCAAGCTGGG|TATCATGTAATTAACCCTGTAAATACCACG
ACCTGATGAGTTTTATGTGAGGGGATGTGA|TGGAAGTTCCACGAGATGCATCAGGGCAAC
TACTGTGAATGGGTGGAGCGGGTGGTACTG|TGAAAAGGACGGCCAATGATGGCAAGGATG
TATGTCGAGACCTTACTGTGAATGGGTGGA|AAGATGCCGGAGACCGTCTGTATACAGCTT
CGTCCTAAGCCTGCAGTTTGCAGTGGGGGC|TATATGCGTGGAAGCGCGTCTACTCTTAGT
GCTGCACTCACATGATCTCATCTTTGTGGA|CGTCGTTTGGCAGGTCGGGGTTCACTGGCC
AGCGCGTCTACTCTTAGTTAAATGGGATCG|CCGTGAGTACTGTGAATGGGTGGAGCGGGT
TTCTGGCGTCGTTTGGCAGGTCGGGGTTCA|AGTTTTTTCGCATCTTACCAAATTCGAGTT
ATGGGTGGAGCGGGTGGGCACTACTGTGAA|TGTACTGTGAATGGGTGGAGCGGGTGGGCA
CAAGTAGGAGTGAAAAGGACGGCCAATGAT|TGTGAATGGGTGGAGCGGGTGGGCACGACG
GAATGGGTGGAGCGGGTGGGCACGACGTAC|TGTGATATATGTCGAGACCTTACTGTGAAT
GGTGGAGCGGGTGGGTACTGTGAATGGGTG|CAGCTTACTGTGAATGGGTGGAGCGGGTGG
TAATGACCTGATGAGTTTTATGTGAGGGGA|CTTTGTGGAAGTTCCACGAGATGCATCAGG
GGTGGAGCGGGTGGGCACGACTCGAACGTA|ACGTCAGTTAGTTTTGGGAAATGCGGCTCA
ATGGGTGGAGCGGGTGGGCACGCACGCTGC|CGGGTGGGCACGAAAGTGGTTCTGGCGTCG
AGATGCCGGAGACCGTCTGTATACAGCTTA|ACGCTTGCGTCTTGACTCACAGAACCGTTA
AGTTTTATGTGAGGGGATGTGATATATGTC|CCACGAGATGCATCAGGGCAACACAAGATG
ACTCTTAGTTAAATGGGATCGGCTTTCTCA|CTGTGAATGGGTGGAGCGGGTGGGCACGAC
TTTGCAGTGGGGGCCTAGGCCCCGGCCGGT|CGTCTACTCTTAGTTAAATGGGATCGGCTT
TCCTAAGCCTGCAGTTTGCAGTGGGGGCCT|TATGCGTGGAAGCGCGTCTACTCTTAGTTA
GTGAATGGGTGGAGCGGGTGGGTACTGTGA|CTGTATACAGCTTACTGTGAATGGGTGGAG
CGTGGAAGCGCGTCTACTCTTAGTTAAATG|ACCACACCGTGAGTACTGTGAATGGGTGGA
AATGGGTGGAGCGGGTGGGCACGCTTGCGT|GAATGGGTGGAGCGGGTGGTACTGTGAATG
CGACCCGGCGGGGACCACACCGTGAGTACT|AGCTCGTCCTGTCTCGTGTGGGATGTCGCT
GGGACCACACCGTGAGTACTGTGAATGGGT|GTCTCGTGTGGGATGTCGCTGAGCAACACG
GTGAATGGGTGGAGCGGGTGGGCACGAAAG|TGGGCACACGCAACTATGGACCAAACCATT
ACGTTCTGTGGTCGGAGCTCAAGGGCAAAT|CTGTGTTCACACCTGTCTTTACTGTGAATG
GAGCGCCCCGCGGAACAACTCCACATGCCC|TGTCAATTAGCGGAACGTCCTAAGCCTGCA
CTGTGGTCGGAGCTCAAGGGCAAATATCAC|TTCACACCTGTCTTTACTGTGAATGGGTGG
CTGTGAATGGGTGGAGCGGGTGGGCACGCT|ACTGTGAATGGGTGGAGCGGGTGGTACTGT
TGGGCACTACTGTGAATGGGTGGAGCGGGT|GTGGAGCGGGTGGGCACGGCCCGAGCGCCC
GCCTGCAGTTTGCAGTGGGGGCCTAGGCCC|TGGAAGCGCGTCTACTCTTAGTTAAATGGG
CACGCTGTCGTCGAGGAGGAGCACCGGGCA|TGGGCACGCACGCTGCACTCACATGATCTC
ATGGGTGGAGCGGGTGGGCACGCAGATAGG|CGCACTGGCAATCCTTTCATATGGACGCCC
GGTGGGCACGCAGATAGGCTACTGTGCGTA|CCTTTCATATGGACGCCCACTCGACCCGGC
GCGGGTGGGCACGGCCCGAGCGCCCCGCGG|TGATCCTAACTGAGCGCTGTCAATTAGCGG
CGCACGCTGCACTCACATGATCTCATCTTT|TCTGGCGTCGTTTGGCAGGTCGGGGTTCAC
GAGACCTTACTGTGAATGGGTGGAGCGGGT|CCGGAGACCGTCTGTATACAGCTTACTGTG
GGCTAATACTGTGAATGGGTGGAGCGGGTG|CGAACGTATGCTGTCAGTACTGTGAATGGG
ACTGGCAATCCTTTCATATGGACGCCCACT|GGCACGCAATGGGCGAATGTGTTACATAAT
GATGCATCAGGGCAACACAAGATGCCGGAG|ATGGGTGGAGCGGGTGGGCACGCTTGCGTC
TCGGGGTTCACTGGCCTGTACTGTGAATGG|AATTCGAGTTAATAAGATGTACTGTGAATG
TACAGCTTACTGTGAATGGGTGGAGCGGGT|GAACCGTTAGTTGGGCACACGCAACTATGG
GTCCTAAGCCTGCAGTTTGCAGTGGGGGCC|ATATGCGTGGAAGCGCGTCTACTCTTAGTT
ACCATTCGCAGTTTTTTCGCATCTTACCAA|CGGGCACGCTACACCCATGCGATCACTTTC
CACGGCCCGAGCGCCCCGCGGAACAACTCC|CTGAGCGCTGTCAATTAGCGGAACGTCCTA
TGGGCACGGTGAATGGGTGGAGCGGGTGGG|TGTGAGGGGATGTGATATATGTCGAGACCT
ACTGTGAATGGGTGGAGCGGGTGGGCACTA|GATGTCGTGTACTGTGAATGGGTGGAGCGG
ACTGTGCGTATATGCGTGGAAGCGCGTCTA|TCGACCCGGCGGGGACCACACCGTGAGTAC
TGTGAGGGGATGTGATATATGTCGAGACCT|ATGCATCAGGGCAACACAAGATGCCGGAGA
TGGAGCGGGTGGGCACGCTTGCGTCTTGAC|GTGGAGCGGGTGGTACTGTGAATGGGTGGA
GGGTGGGTACTGTGAATGGGTGGAGCGGGT|TGTGAATGGGTGGAGCGGGTGGGCACGAAA
CAGACCCAAAACACTCCCAAGCTGGGCTTC|ATGTAATTAACCCTGTAAATACCACGCTGT
GTTCCACGAGATGCATCAGGGCAACACAAG|GTACTGTGAATGGGTGGAGCGGGTGGGCAC
TTTATGTGAGGGGATGTGATATATGTCGAG|CGAGATGCATCAGGGCAACACAAGATGCCG
CTGTATACAGCTTACTGTGAATGGGTGGAG|TCACAGAACCGTTAGTTGGGCACACGCAAC
CAGGTCGGGGTTCACTGGCCTGTACTGTGA|ACCAAATTCGAGTTAATAAGATGTACTGTG
GCGGAACGTCCTAAGCCTGCAGTTTGCAGT|TGTGCGTATATGCGTGGAAGCGCGTCTACT
AAGCTGGGCTTCAACTGGTCGGATATAGAC|ATACCACGCTGTCGTCGAGGAGGAGCACCG
CTATGGACCAAACCATTCGCAGTTTTTTCG|GCGGGTGGGCACGGGCACGCTACACCCATG
TCCGAAATTAAATACAGTTGTGGCCAGACC|CGACGTACCCCGTGCTGCTCTATCATGTAA
CGGGGTTCACTGGCCTGTACTGTGAATGGG|ATTCGAGTTAATAAGATGTACTGTGAATGG
TGGACCAAACCATTCGCAGTTTTTTCGCAT|GGTGGGCACGGGCACGCTACACCCATGCGA
AACCATTCGCAGTTTTTTCGCATCTTACCA|ACGGGCACGCTACACCCATGCGATCACTTT
GGTGCGGCTGTGTTCACACCTGTCTTTACT|AATACTGTGAATGGGTGGAGCGGGTGGGCA
GAGGGGATGTGATATATGTCGAGACCTTAC|CATCAGGGCAACACAAGATGCCGGAGACCG
GTCGTTTGGCAGGTCGGGGTTCACTGGCCT|TCGCATCTTACCAAATTCGAGTTAATAAGA
TTAATGACCTGATGAGTTTTATGTGAGGGG|TCTTTGTGGAAGTTCCACGAGATGCATCAG
GGAGACCGTCTGTATACAGCTTACTGTGAA|CGTCTTGACTCACAGAACCGTTAGTTGGGC
TACTGTGAATGGGTGGAGCGGGTGGGCACG|GGCACGACCGCACTGGCAATCCTTTCATAT
ACCCTGTAAATACCACGCTGTCGTCGAGGA|TGGGTGGAGCGGGTGGGCACGCACGCTGCA
AGCTGGGCTTCAACTGGTCGGATATAGACT|TACCACGCTGTCGTCGAGGAGGAGCACCGG
GTGGGCACGCTTGCGTCTTGACTCACAGAA|GGTGGTACTGTGAATGGGTGGAGCGGGTGG
GACGTACCCCGTGCTGCTCTATCATGTAAT|TGTGAATGGGTGGAGCGGGTGGGTACTGTG
TGGAGCGGGTGGTACTGTGAATGGGTGGAG|CAATGATGGCAAGGATGTCGTGTACTGTGA
GGTCGGATATAGACTACTTACTGTGAATGG|GAGGAGGAGCACCGGGCATTTAATGACCTG
CTGTGAATGGGTGGAGCGGGTGGGCACTAC|ATGTCGTGTACTGTGAATGGGTGGAGCGGG
ATTCGCAGTTTTTTCGCATCTTACCAAATT|GCACGCTACACCCATGCGATCACTTTCGTG
GCCCGTATGGTCTATCAGTTAGTACTGTGA|TGCAGTTTGCAGTGGGGGCCTAGGCCCCGG
ACTGATCCTAACTGAGCGCTGTCAATTAGC|GGAGCGGGTGGGCACGCAGATAGGCTACTG
ACTGTGAATGGGTGGAGCGGGTGGGCACGA|ATGCTGTCAGTACTGTGAATGGGTGGAGCG
ATCATGTAATTAACCCTGTAAATACCACGC|GGGTACTGTGAATGGGTGGAGCGGGTGGGC
CCACACCGTGAGTACTGTGAATGGGTGGAG|CGTGTGGGATGTCGCTGAGCAACACGTCAG
TAGGCTACTGTGCGTATATGCGTGGAAGCG|GCCCACTCGACCCGGCGGGGACCACACCGT
GAGCGGGTGGGCACTACTGTGAATGGGTGG|TGAATGGGTGGAGCGGGTGGGCACGGCCCG
GGGCTTCAACTGGTCGGATATAGACTACTT|ACGCTGTCGTCGAGGAGGAGCACCGGGCAT
GCACGGGCACGCTACACCCATGCGATCACT|CGGAACAACTCCACATGCCCGTATGGTCTA
CGTATGCTGTCAGTACTGTGAATGGGTGGA|CTCAGGAATTGGTTCACTGGTCTCTTATAG
GGCACGCACGCTGCACTCACATGATCTCAT|TGGTTCTGGCGTCGTTTGGCAGGTCGGGGT
AGACCGTCTGTATACAGCTTACTGTGAATG|TCTTGACTCACAGAACCGTTAGTTGGGCAC
GCGGGTGGGCACGACCGCACTGGCAATCCT|GAATGGGTGGAGCGGGTGGGCACGCAATGG
AACAACTCCACATGCCCGTATGGTCTATCA|AACGTCCTAAGCCTGCAGTTTGCAGTGGGG
AAAACACTCCCAAGCTGGGCTTCAACTGGT|TAACCCTGTAAATACCACGCTGTCGTCGAG
AGCGGGTGGGCACGACGTTCTGTGGTCGGA|CTTTTTGGGTGCGGCTGTGTTCACACCTGT
GGTCGTCTTTTTGGGTGCGGCTGTGTTCAC|CTTTCTCACGGCTAATACTGTGAATGGGTG
GGGCACGGCCCGAGCGCCCCGCGGAACAAC|TAACTGAGCGCTGTCAATTAGCGGAACGTC
TGGAGCGGGTGGGCACGGGCACGCTACACC|CCGAGCGCCCCGCGGAACAACTCCACATGC
TGGGCACGGGCACGCTACACCCATGCGATC|CCGCGGAACAACTCCACATGCCCGTATGGT
GTGGGCACGGCCCGAGCGCCCCGCGGAACA|CCTAACTGAGCGCTGTCAATTAGCGGAACG
GTGGGCACTACTGTGAATGGGTGGAGCGGG|GGTGGAGCGGGTGGGCACGGCCCGAGCGCC
CCCACTCGACCCGGCGGGGACCACACCGTG|CATAATAGCTCGTCCTGTCTCGTGTGGGAT
GGGCAAATATCACTGATCCTAACTGAGCGC|TGTGAATGGGTGGAGCGGGTGGGCACGCAG
ATGGGTGGAGCGGGTGGGCACGACGTTCTG|CCGGTCGTCTTTTTGGGTGCGGCTGTGTTC
GCACGACGTACCCCGTGCTGCTCTATCATG|TTACTGTGAATGGGTGGAGCGGGTGGGTAC
TTTTATGTGAGGGGATGTGATATATGTCGA|ACGAGATGCATCAGGGCAACACAAGATGCC
GTGAAAAGGACGGCCAATGATGGCAAGGAT|GTGGAGCGGGTGGGCACGACGTTCTGTGGT
GCTTGCGTCTTGACTCACAGAACCGTTAGT|TGTGAATGGGTGGAGCGGGTGGGCACTACT
CTGGCCTGTACTGTGAATGGGTGGAGCGGG|AATAAGATGTACTGTGAATGGGTGGAGCGG
GGTGGAGCGGGTGGGCACGACGTACCCCGT|TATATGTCGAGACCTTACTGTGAATGGGTG
GAGCGGGTGGGCACGCACGCTGCACTCACA|GCACGAAAGTGGTTCTGGCGTCGTTTGGCA
GCGTGGAAGCGCGTCTACTCTTAGTTAAAT|GACCACACCGTGAGTACTGTGAATGGGTGG
GATCACTTTCGTGAACCTCAAGTAGGAGTG|TGGTCTATCAGTTAGTACTGTGAATGGGTG
GTCGTCTTTTTGGGTGCGGCTGTGTTCACA|TTTCTCACGGCTAATACTGTGAATGGGTGG
AATGGGTGGAGCGGGTGGGCACGACCGCAC|TCAGTACTGTGAATGGGTGGAGCGGGTGGG
GGTGGAGCGGGTGGGCACTACTGTGAATGG|ACTGTGAATGGGTGGAGCGGGTGGGCACGG
TGGAGCGGGTGGGCACGGCCCGAGCGCCCC|TCACTGATCCTAACTGAGCGCTGTCAATTA
GTTAATAAGATGTACTGTGAATGGGTGGAG|CTCAAGTAGGAGTGAAAAGGACGGCCAATG
GGTGGAGCGGGTGGGCACGGGCACGCTACA|GCCCGAGCGCCCCGCGGAACAACTCCACAT
TGGAGCGGGTGGGCACGGTGAATGGGTGGA|TGAGTTTTATGTGAGGGGATGTGATATATG
TGTAAATACCACGCTGTCGTCGAGGAGGAG|TGGAGCGGGTGGGCACGCACGCTGCACTCA
TGAATGGGTGGAGCGGGTGGGCACGCTTGC|GTGAATGGGTGGAGCGGGTGGTACTGTGAA
CGGGTGGGCACGACTCGAACGTATGCTGTC|TTAGTTTTGGGAAATGCGGCTCAGGAATTG
ACGCCCACTCGACCCGGCGGGGACCACACC|TTACATAATAGCTCGTCCTGTCTCGTGTGG
GGGCCTAGGCCCCGGCCGGTCGTCTTTTTG|TAGTTAAATGGGATCGGCTTTCTCACGGCT
ATGACCTGATGAGTTTTATGTGAGGGGATG|TTGTGGAAGTTCCACGAGATGCATCAGGGC
GAATGGGTGGAGCGGGTGGGTACTGTGAAT|GTATACAGCTTACTGTGAATGGGTGGAGCG
GGCCCGAGCGCCCCGCGGAACAACTCCACA|AGCGCTGTCAATTAGCGGAACGTCCTAAGC
CGGGTGGGCACGGTGAATGGGTGGAGCGGG|TTTATGTGAGGGGATGTGATATATGTCGAG
ACGCTTGCGTCTTGACTCACAGAACCGTTA|ACTGTGAATGGGTGGAGCGGGTGGGCACTA
GATGTACTGTGAATGGGTGGAGCGGGTGGT|GGAGTGAAAAGGACGGCCAATGATGGCAAG
CACTCCCAAGCTGGGCTTCAACTGGTCGGA|CCTGTAAATACCACGCTGTCGTCGAGGAGG
CTTACTGTGAATGGGTGGAGCGGGTGGGCA|CATTTAATGACCTGATGAGTTTTATGTGAG
GCTCTATCATGTAATTAACCCTGTAAATAC|CGGGTGGGTACTGTGAATGGGTGGAGCGGG
GTCTTTACTGTGAATGGGTGGAGCGGGTGG|GGGTGGGCACGACCGCACTGGCAATCCTTT
TGGGCACGCACGCTGCACTCACATGATCTC|AGTGGTTCTGGCGTCGTTTGGCAGGTCGGG
AGGAGTGAAAAGGACGGCCAATGATGGCAA|ATGGGTGGAGCGGGTGGGCACGACGTTCTG
TCCCAAGCTGGGCTTCAACTGGTCGGATAT|GTAAATACCACGCTGTCGTCGAGGAGGAGC
TGACCTGATGAGTTTTATGTGAGGGGATGT|TGTGGAAGTTCCACGAGATGCATCAGGGCA
CTCCACATGCCCGTATGGTCTATCAGTTAG|CCTAAGCCTGCAGTTTGCAGTGGGGGCCTA
AACCTCAAGTAGGAGTGAAAAGGACGGCCA|AGTACTGTGAATGGGTGGAGCGGGTGGGCA
TGGAGCGGGTGGGCACGACTCGAACGTATG|GTCAGTTAGTTTTGGGAAATGCGGCTCAGG
GTGGGCACGACGTACCCCGTGCTGCTCTAT|GACCTTACTGTGAATGGGTGGAGCGGGTGG
CGTCTTTTTGGGTGCGGCTGTGTTCACACC|TCTCACGGCTAATACTGTGAATGGGTGGAG
CATGATCTCATCTTTGTGGAAGTTCCACGA|CAGGTCGGGGTTCACTGGCCTGTACTGTGA
GATGCCGGAGACCGTCTGTATACAGCTTAC|CGCTTGCGTCTTGACTCACAGAACCGTTAG
ATCACTTTCGTGAACCTCAAGTAGGAGTGA|GGTCTATCAGTTAGTACTGTGAATGGGTGG
AATGGGATCGGCTTTCTCACGGCTAATACT|TGGAGCGGGTGGGCACGACTCGAACGTATG
CACTCACATGATCTCATCTTTGTGGAAGTT|GTTTGGCAGGTCGGGGTTCACTGGCCTGTA
TGAATGGGTGGAGCGGGTGGGCACGCAGAT|GACCGCACTGGCAATCCTTTCATATGGACG
AATTAACCCTGTAAATACCACGCTGTCGTC|GTGAATGGGTGGAGCGGGTGGGCACGCACG
GGAGCGGGTGGGCACGACGTTCTGTGGTCG|GTCTTTTTGGGTGCGGCTGTGTTCACACCT
TGTGAATGGGTGGAGCGGGTGGGCACGCTT|CTGTGAATGGGTGGAGCGGGTGGTACTGTG
TTTTCCGAAATTAAATACAGTTGTGGCCAG|GCACGACGTACCCCGTGCTGCTCTATCATG
TGTGAATGGGTGGAGCGGGTGGGTACTGTG|TCTGTATACAGCTTACTGTGAATGGGTGGA
CAAATTCGAGTTAATAAGATGTACTGTGAA|TTCGTGAACCTCAAGTAGGAGTGAAAAGGA
TGAATGGGTGGAGCGGGTGGGCACGGCCCG|GGCAAATATCACTGATCCTAACTGAGCGCT
AGGATGTCGTGTACTGTGAATGGGTGGAGC|GTGGTCGGAGCTCAAGGGCAAATATCACTG
GGGGATGTGATATATGTCGAGACCTTACTG|TCAGGGCAACACAAGATGCCGGAGACCGTC
AAAGGACGGCCAATGATGGCAAGGATGTCG|AGCGGGTGGGCACGACGTTCTGTGGTCGGA
GTGAATGGGTGGAGCGGGTGGGCACGCTTG|TGTGAATGGGTGGAGCGGGTGGTACTGTGA
CCAAATTCGAGTTAATAAGATGTACTGTGA|TTTCGTGAACCTCAAGTAGGAGTGAAAAGG
CCGGCGGGGACCACACCGTGAGTACTGTGA|CGTCCTGTCTCGTGTGGGATGTCGCTGAGC
CGGGTGGGCACGCACGCTGCACTCACATGA|CGAAAGTGGTTCTGGCGTCGTTTGGCAGGT
GGGGCCTAGGCCCCGGCCGGTCGTCTTTTT|TTAGTTAAATGGGATCGGCTTTCTCACGGC
TGTGAATGGGTGGAGCGGGTGGGCACGGCC|AGGGCAAATATCACTGATCCTAACTGAGCG
CGTCGAGGAGGAGCACCGGGCATTTAATGA|CACGCTGCACTCACATGATCTCATCTTTGT
ACCTCAAGTAGGAGTGAAAAGGACGGCCAA|GTACTGTGAATGGGTGGAGCGGGTGGGCAC
GCACACGCAACTATGGACCAAACCATTCGC|AATGGGTGGAGCGGGTGGGCACGGGCACGC
ACTCCCAAGCTGGGCTTCAACTGGTCGGAT|CTGTAAATACCACGCTGTCGTCGAGGAGGA
GCACGACCGCACTGGCAATCCTTTCATATG|GGAGCGGGTGGGCACGCAATGGGCGAATGT
GGAGCGGGTGGGCACGGCCCGAGCGCCCCG|CACTGATCCTAACTGAGCGCTGTCAATTAG
AATGGGTGGAGCGGGTGGGCACGCAGATAG|CCGCACTGGCAATCCTTTCATATGGACGCC
AACGTATGCTGTCAGTACTGTGAATGGGTG|GGCTCAGGAATTGGTTCACTGGTCTCTTAT
ACTCGAACGTATGCTGTCAGTACTGTGAAT|AATGCGGCTCAGGAATTGGTTCACTGGTCT
GGGTGGGCACGGGCACGCTACACCCATGCG|GCCCCGCGGAACAACTCCACATGCCCGTAT
GTACTGTGAATGGGTGGAGCGGGTGGGCAC|TCGCTGAGCAACACGTCAGTTAGTTTTGGG
GCACGACGTTCTGTGGTCGGAGCTCAAGGG|TGCGGCTGTGTTCACACCTGTCTTTACTGT
GTCAATTAGCGGAACGTCCTAAGCCTGCAG|TAGGCTACTGTGCGTATATGCGTGGAAGCG
GGGTGGGCACGGCCCGAGCGCCCCGCGGAA|ATCCTAACTGAGCGCTGTCAATTAGCGGAA
TGGAGCGGGTGGGCACGACCGCACTGGCAA|CTGTGAATGGGTGGAGCGGGTGGGCACGCA
GAATGGGTGGAGCGGGTGGGCACGACTCGA|GCAACACGTCAGTTAGTTTTGGGAAATGCG
CTCCCAAGCTGGGCTTCAACTGGTCGGATA|TGTAAATACCACGCTGTCGTCGAGGAGGAG
GTTAAATGGGATCGGCTTTCTCACGGCTAA|TGGGTGGAGCGGGTGGGCACGACTCGAACG
AGCGGGTGGGCACTACTGTGAATGGGTGGA|GAATGGGTGGAGCGGGTGGGCACGGCCCGA
CTCTATCATGTAATTAACCCTGTAAATACC|GGGTGGGTACTGTGAATGGGTGGAGCGGGT
TTCACTGGCCTGTACTGTGAATGGGTGGAG|AGTTAATAAGATGTACTGTGAATGGGTGGA
TTCATATGGACGCCCACTCGACCCGGCGGG|GCGAATGTGTTACATAATAGCTCGTCCTGT
GGATGTCGTGTACTGTGAATGGGTGGAGCG|TGGTCGGAGCTCAAGGGCAAATATCACTGA
AATGGGTGGAGCGGGTGGGCACTACTGTGA|GTGTACTGTGAATGGGTGGAGCGGGTGGGC
CAGTTGTGGCCAGACCCAAAACACTCCCAA|CTGCTCTATCATGTAATTAACCCTGTAAAT
AAGATGTACTGTGAATGGGTGGAGCGGGTG|TAGGAGTGAAAAGGACGGCCAATGATGGCA
CGCTTGCGTCTTGACTCACAGAACCGTTAG|CTGTGAATGGGTGGAGCGGGTGGGCACTAC
TCGGCTTTCTCACGGCTAATACTGTGAATG|GGTGGGCACGACTCGAACGTATGCTGTCAG
CCCGGCGGGGACCACACCGTGAGTACTGTG|TCGTCCTGTCTCGTGTGGGATGTCGCTGAG
GGGCACACGCAACTATGGACCAAACCATTC|TGAATGGGTGGAGCGGGTGGGCACGGGCAC
ATGCGATCACTTTCGTGAACCTCAAGTAGG|CGTATGGTCTATCAGTTAGTACTGTGAATG
TCGTCGAGGAGGAGCACCGGGCATTTAATG|GCACGCTGCACTCACATGATCTCATCTTTG
ACCTGTCTTTACTGTGAATGGGTGGAGCGG|GAGCGGGTGGGCACGACCGCACTGGCAATC
TGTACTGTGAATGGGTGGAGCGGGTGGGCA|GCTCAAGGGCAAATATCACTGATCCTAACT
CCGGGCATTTAATGACCTGATGAGTTTTAT|TGATCTCATCTTTGTGGAAGTTCCACGAGA
ATGGGTGGAGCGGGTGGTACTGTGAATGGG|ACGGCCAATGATGGCAAGGATGTCGTGTAC
AAAAGGACGGCCAATGATGGCAAGGATGTC|GAGCGGGTGGGCACGACGTTCTGTGGTCGG
GTGAATGGGTGGAGCGGGTGGGCACGACTC|GAGCAACACGTCAGTTAGTTTTGGGAAATG
CTGTGAATGGGTGGAGCGGGTGGGCACGCA|CACGACCGCACTGGCAATCCTTTCATATGG
CTTACCAAATTCGAGTTAATAAGATGTACT|TCACTTTCGTGAACCTCAAGTAGGAGTGAA
AGTTTTTTCGCATCTTACCAAATTCGAGTT|TACACCCATGCGATCACTTTCGTGAACCTC
GCACGCTACACCCATGCGATCACTTTCGTG|AACTCCACATGCCCGTATGGTCTATCAGTT
TTCTCACGGCTAATACTGTGAATGGGTGGA|CACGACTCGAACGTATGCTGTCAGTACTGT
TCTTACCAAATTCGAGTTAATAAGATGTAC|ATCACTTTCGTGAACCTCAAGTAGGAGTGA
TGGCAGGTCGGGGTTCACTGGCCTGTACTG|CTTACCAAATTCGAGTTAATAAGATGTACT
CTGTGAATGGGTGGAGCGGGTGGGCACGGC|AAGGGCAAATATCACTGATCCTAACTGAGC
AGCTCAAGGGCAAATATCACTGATCCTAAC|TCTTTACTGTGAATGGGTGGAGCGGGTGGG
GTGAATGGGTGGAGCGGGTGGGCACGGCCC|GGGCAAATATCACTGATCCTAACTGAGCGC
CACTGGCCTGTACTGTGAATGGGTGGAGCG|TTAATAAGATGTACTGTGAATGGGTGGAGC
CCGTATGGTCTATCAGTTAGTACTGTGAAT|CAGTTTGCAGTGGGGGCCTAGGCCCCGGCC
TACTGTGAATGGGTGGAGCGGGTGGGCACG|GGGTGGAGCGGGTGGGCACGAAAGTGGTTC
GGATGTGATATATGTCGAGACCTTACTGTG|AGGGCAACACAAGATGCCGGAGACCGTCTG
TGGAAGCGCGTCTACTCTTAGTTAAATGGG|CACACCGTGAGTACTGTGAATGGGTGGAGC
GCGGGTGGGCACGAAAGTGGTTCTGGCGTC|CTATGGACCAAACCATTCGCAGTTTTTTCG
GCCAGACCCAAAACACTCCCAAGCTGGGCT|TCATGTAATTAACCCTGTAAATACCACGCT
CATCTTACCAAATTCGAGTTAATAAGATGT|CGATCACTTTCGTGAACCTCAAGTAGGAGT
GTGAATGGGTGGAGCGGGTGGGCACGGGCA|GGGCACGGCCCGAGCGCCCCGCGGAACAAC
TTGGGTGCGGCTGTGTTCACACCTGTCTTT|GCTAATACTGTGAATGGGTGGAGCGGGTGG
TAATAAGATGTACTGTGAATGGGTGGAGCG|CAAGTAGGAGTGAAAAGGACGGCCAATGAT
ATGGGTGGAGCGGGTGGGCACGACCGCACT|CAGTACTGTGAATGGGTGGAGCGGGTGGGC
GAGGAGGAGCACCGGGCATTTAATGACCTG|CTGCACTCACATGATCTCATCTTTGTGGAA
GCAACTATGGACCAAACCATTCGCAGTTTT|TGGAGCGGGTGGGCACGGGCACGCTACACC
GTACTGTGAATGGGTGGAGCGGGTGGGCAC|TGGGTGGAGCGGGTGGGCACGAAAGTGGTT
ATCTTACCAAATTCGAGTTAATAAGATGTA|GATCACTTTCGTGAACCTCAAGTAGGAGTG
ACTGTGAATGGGTGGAGCGGGTGGGCACGG|CAAGGGCAAATATCACTGATCCTAACTGAG
ACCACGCTGTCGTCGAGGAGGAGCACCGGG|GGTGGGCACGCACGCTGCACTCACATGATC
TACTGTGCGTATATGCGTGGAAGCGCGTCT|CTCGACCCGGCGGGGACCACACCGTGAGTA
ACTGTGAATGGGTGGAGCGGGTGGGCACGA|AGTTGGGCACACGCAACTATGGACCAAACC
GTGTTCACACCTGTCTTTACTGTGAATGGG|AATGGGTGGAGCGGGTGGGCACGACCGCAC
TAAGATGTACTGTGAATGGGTGGAGCGGGT|GTAGGAGTGAAAAGGACGGCCAATGATGGC
GGGTACTGTGAATGGGTGGAGCGGGTGGGC|AATGGGTGGAGCGGGTGGGCACGAAAGTGG
CTACTGTGCGTATATGCGTGGAAGCGCGTC|ACTCGACCCGGCGGGGACCACACCGTGAGT
TGGGCACGACTCGAACGTATGCTGTCAGTA|TTTTGGGAAATGCGGCTCAGGAATTGGTTC
CTGTCAATTAGCGGAACGTCCTAAGCCTGC|GATAGGCTACTGTGCGTATATGCGTGGAAG
AGAACCGTTAGTTGGGCACACGCAACTATG|GTGGGCACTACTGTGAATGGGTGGAGCGGG
GGCAGGTCGGGGTTCACTGGCCTGTACTGT|TTACCAAATTCGAGTTAATAAGATGTACTG
CACATGCCCGTATGGTCTATCAGTTAGTAC|AAGCCTGCAGTTTGCAGTGGGGGCCTAGGC
TTAAGCCTTTTCCGAAATTAAATACAGTTG|CGGGTGGGCACGACGTACCCCGTGCTGCTC
TCGGAGCTCAAGGGCAAATATCACTGATCC|CCTGTCTTTACTGTGAATGGGTGGAGCGGG
TTAGTTAAATGGGATCGGCTTTCTCACGGC|GAATGGGTGGAGCGGGTGGGCACGACTCGA
GGATATAGACTACTTACTGTGAATGGGTGG|AGGAGCACCGGGCATTTAATGACCTGATGA
AGGGCAAATATCACTGATCCTAACTGAGCG|CTGTGAATGGGTGGAGCGGGTGGGCACGCA
CGTCTACTCTTAGTTAAATGGGATCGGCTT|GAGTACTGTGAATGGGTGGAGCGGGTGGGC
GCACGGCCCGAGCGCCCCGCGGAACAACTC|ACTGAGCGCTGTCAATTAGCGGAACGTCCT
TGGAGCGGGTGGGCACGACGTTCTGTGGTC|CGTCTTTTTGGGTGCGGCTGTGTTCACACC
AAATTAAATACAGTTGTGGCCAGACCCAAA|GTACCCCGTGCTGCTCTATCATGTAATTAA
GACGCCCACTCGACCCGGCGGGGACCACAC|GTTACATAATAGCTCGTCCTGTCTCGTGTG
AACTGAGCGCTGTCAATTAGCGGAACGTCC|GGGCACGCAGATAGGCTACTGTGCGTATAT
AAAGTGGTTCTGGCGTCGTTTGGCAGGTCG|CATTCGCAGTTTTTTCGCATCTTACCAAAT
GGTGGGCACGACCGCACTGGCAATCCTTTC|TGGGTGGAGCGGGTGGGCACGCAATGGGCG
TGAATGGGTGGAGCGGGTGGGCACGCACGC|GAGCGGGTGGGCACGAAAGTGGTTCTGGCG
TTACTGTGAATGGGTGGAGCGGGTGGGCAC|GGGCACGACCGCACTGGCAATCCTTTCATA
AGCGGGTGGGCACGGCCCGAGCGCCCCGCG|CTGATCCTAACTGAGCGCTGTCAATTAGCG
CACGAAAGTGGTTCTGGCGTCGTTTGGCAG|AAACCATTCGCAGTTTTTTCGCATCTTACC
ACTGTGAATGGGTGGAGCGGGTGGGCACGC|GGTGGAGCGGGTGGGCACGAAAGTGGTTCT
TGTGAATGGGTGGAGCGGGTGGGCACGACG|CCCGGCCGGTCGTCTTTTTGGGTGCGGCTG
GGGTGGGCACGCACGCTGCACTCACATGAT|GAAAGTGGTTCTGGCGTCGTTTGGCAGGTC
TTTCTCACGGCTAATACTGTGAATGGGTGG|GCACGACTCGAACGTATGCTGTCAGTACTG
TGTGGAAGTTCCACGAGATGCATCAGGGCA|CTGGCCTGTACTGTGAATGGGTGGAGCGGG
GTGAATGGGTGGAGCGGGTGGGCACGCAGA|CGACCGCACTGGCAATCCTTTCATATGGAC
TGGGTACTGTGAATGGGTGGAGCGGGTGGG|GAATGGGTGGAGCGGGTGGGCACGAAAGTG
AGATGTACTGTGAATGGGTGGAGCGGGTGG|AGGAGTGAAAAGGACGGCCAATGATGGCAA
ATCACTGATCCTAACTGAGCGCTGTCAATT|GGTGGAGCGGGTGGGCACGCAGATAGGCTA
TGCACTCACATGATCTCATCTTTGTGGAAG|TCGTTTGGCAGGTCGGGGTTCACTGGCCTG
CGGGTGGGCACGCAGATAGGCTACTGTGCG|ATCCTTTCATATGGACGCCCACTCGACCCG
ACGGCTAATACTGTGAATGGGTGGAGCGGG|CTCGAACGTATGCTGTCAGTACTGTGAATG
GGCCAGACCCAAAACACTCCCAAGCTGGGC|ATCATGTAATTAACCCTGTAAATACCACGC
CCACATGCCCGTATGGTCTATCAGTTAGTA|TAAGCCTGCAGTTTGCAGTGGGGGCCTAGG
CATATGGACGCCCACTCGACCCGGCGGGGA|GAATGTGTTACATAATAGCTCGTCCTGTCT
AATTCGAGTTAATAAGATGTACTGTGAATG|CGTGAACCTCAAGTAGGAGTGAAAAGGACG
GTACTGTGAATGGGTGGAGCGGGTGGTACT|GTGAAAAGGACGGCCAATGATGGCAAGGAT
GTACTGTGAATGGGTGGAGCGGGTGGGCAC|AGGCCCCGGCCGGTCGTCTTTTTGGGTGCG
GCATTTAATGACCTGATGAGTTTTATGTGA|CTCATCTTTGTGGAAGTTCCACGAGATGCA
GCAGATAGGCTACTGTGCGTATATGCGTGG|TGGACGCCCACTCGACCCGGCGGGGACCAC
TGGGCACGACCGCACTGGCAATCCTTTCAT|GGTGGAGCGGGTGGGCACGCAATGGGCGAA
TGAATGGGTGGAGCGGGTGGGCACGACCGC|TGTCAGTACTGTGAATGGGTGGAGCGGGTG
ACCCGGCGGGGACCACACCGTGAGTACTGT|CTCGTCCTGTCTCGTGTGGGATGTCGCTGA
GAATGGGTGGAGCGGGTGGTACTGTGAATG|GGACGGCCAATGATGGCAAGGATGTCGTGT
GTTCTGTGGTCGGAGCTCAAGGGCAAATAT|GTGTTCACACCTGTCTTTACTGTGAATGGG
TTAAATACAGTTGTGGCCAGACCCAAAACA|CCCCGTGCTGCTCTATCATGTAATTAACCC
ACAAGATGCCGGAGACCGTCTGTATACAGC|GGCACGCTTGCGTCTTGACTCACAGAACCG
GGCCGGTCGTCTTTTTGGGTGCGGCTGTGT|TCGGCTTTCTCACGGCTAATACTGTGAATG
CTTTTCCGAAATTAAATACAGTTGTGGCCA|GGCACGACGTACCCCGTGCTGCTCTATCAT
AACACTCCCAAGCTGGGCTTCAACTGGTCG|ACCCTGTAAATACCACGCTGTCGTCGAGGA
ATATGGACGCCCACTCGACCCGGCGGGGAC|AATGTGTTACATAATAGCTCGTCCTGTCTC
ACTCCACATGCCCGTATGGTCTATCAGTTA|TCCTAAGCCTGCAGTTTGCAGTGGGGGCCT
AAATACCACGCTGTCGTCGAGGAGGAGCAC|AGCGGGTGGGCACGCACGCTGCACTCACAT
GGCACGGGCACGCTACACCCATGCGATCAC|GCGGAACAACTCCACATGCCCGTATGGTCT
CGGGTGGGCACGCTTGCGTCTTGACTCACA|GCGGGTGGTACTGTGAATGGGTGGAGCGGG
GCGGAACAACTCCACATGCCCGTATGGTCT|GCGGAACGTCCTAAGCCTGCAGTTTGCAGT
AGGTCGGGGTTCACTGGCCTGTACTGTGAA|CCAAATTCGAGTTAATAAGATGTACTGTGA
ATAGGCTACTGTGCGTATATGCGTGGAAGC|CGCCCACTCGACCCGGCGGGGACCACACCG
TTCCACGAGATGCATCAGGGCAACACAAGA|TACTGTGAATGGGTGGAGCGGGTGGGCACG
CGTATATGCGTGGAAGCGCGTCTACTCTTA|CGGCGGGGACCACACCGTGAGTACTGTGAA
GGAGCTCAAGGGCAAATATCACTGATCCTA|TGTCTTTACTGTGAATGGGTGGAGCGGGTG
CAACTGGTCGGATATAGACTACTTACTGTG|TCGTCGAGGAGGAGCACCGGGCATTTAATG
AAGCCTTTTCCGAAATTAAATACAGTTGTG|GGTGGGCACGACGTACCCCGTGCTGCTCTA
CCCGCGGAACAACTCCACATGCCCGTATGG|TTAGCGGAACGTCCTAAGCCTGCAGTTTGC
ATTCGAGTTAATAAGATGTACTGTGAATGG|GTGAACCTCAAGTAGGAGTGAAAAGGACGG
GGCTTTCTCACGGCTAATACTGTGAATGGG|TGGGCACGACTCGAACGTATGCTGTCAGTA
GTGGGCACGACTCGAACGTATGCTGTCAGT|GTTTTGGGAAATGCGGCTCAGGAATTGGTT
CAATTAGCGGAACGTCCTAAGCCTGCAGTT|GGCTACTGTGCGTATATGCGTGGAAGCGCG
GATAGGCTACTGTGCGTATATGCGTGGAAG|ACGCCCACTCGACCCGGCGGGGACCACACC
CACGGTGAATGGGTGGAGCGGGTGGGCACG|AGGGGATGTGATATATGTCGAGACCTTACT
CAAGGGCAAATATCACTGATCCTAACTGAG|TACTGTGAATGGGTGGAGCGGGTGGGCACG
GAATGGGTGGAGCGGGTGGGCACGCACGCT|AGCGGGTGGGCACGAAAGTGGTTCTGGCGT
AAACACTCCCAAGCTGGGCTTCAACTGGTC|AACCCTGTAAATACCACGCTGTCGTCGAGG
CCTGTCTTTACTGTGAATGGGTGGAGCGGG|AGCGGGTGGGCACGACCGCACTGGCAATCC
TATGGTCTATCAGTTAGTACTGTGAATGGG|TTTGCAGTGGGGGCCTAGGCCCCGGCCGGT
GGCACGCAGATAGGCTACTGTGCGTATATG|TCATATGGACGCCCACTCGACCCGGCGGGG
GTGGGCACGACCGCACTGGCAATCCTTTCA|GGGTGGAGCGGGTGGGCACGCAATGGGCGA
ACGAGATGCATCAGGGCAACACAAGATGCC|GTGAATGGGTGGAGCGGGTGGGCACGCTTG
CGAAATTAAATACAGTTGTGGCCAGACCCA|ACGTACCCCGTGCTGCTCTATCATGTAATT
CAAGGATGTCGTGTACTGTGAATGGGTGGA|CTGTGGTCGGAGCTCAAGGGCAAATATCAC
TACTGTGAATGGGTGGAGCGGGTGGGCACG|TATGCTGTCAGTACTGTGAATGGGTGGAGC
ATACAGCTTACTGTGAATGGGTGGAGCGGG|AGAACCGTTAGTTGGGCACACGCAACTATG
GCTTTCTCACGGCTAATACTGTGAATGGGT|GGGCACGACTCGAACGTATGCTGTCAGTAC
GCACGACTCGAACGTATGCTGTCAGTACTG|TGGGAAATGCGGCTCAGGAATTGGTTCACT
TGGCAATCCTTTCATATGGACGCCCACTCG|CACGCAATGGGCGAATGTGTTACATAATAG
CTGTACTGTGAATGGGTGGAGCGGGTGGGC|GATGTACTGTGAATGGGTGGAGCGGGTGGT
CCGTGAGTACTGTGAATGGGTGGAGCGGGT|GGGATGTCGCTGAGCAACACGTCAGTTAGT
GGAACGTCCTAAGCCTGCAGTTTGCAGTGG|TGCGTATATGCGTGGAAGCGCGTCTACTCT
CAGATAGGCTACTGTGCGTATATGCGTGGA|GGACGCCCACTCGACCCGGCGGGGACCACA
AACTATGGACCAAACCATTCGCAGTTTTTT|GAGCGGGTGGGCACGGGCACGCTACACCCA
GGGATGTGATATATGTCGAGACCTTACTGT|CAGGGCAACACAAGATGCCGGAGACCGTCT
GTCGTCGAGGAGGAGCACCGGGCATTTAAT|CGCACGCTGCACTCACATGATCTCATCTTT
ATGCATCAGGGCAACACAAGATGCCGGAGA|TGGGTGGAGCGGGTGGGCACGCTTGCGTCT
TACTGTGAATGGGTGGAGCGGGTGGGCACG|TAGTTGGGCACACGCAACTATGGACCAAAC
CCTTTCATATGGACGCCCACTCGACCCGGC|TGGGCGAATGTGTTACATAATAGCTCGTCC
TGAATGGGTGGAGCGGGTGGGCACGAAAGT|GGGCACACGCAACTATGGACCAAACCATTC
GGTTCACTGGCCTGTACTGTGAATGGGTGG|CGAGTTAATAAGATGTACTGTGAATGGGTG
TGGGTGGAGCGGGTGGGCACGGGCACGCTA|CGGCCCGAGCGCCCCGCGGAACAACTCCAC
GGTGGAGCGGGTGGGCACGCAGATAGGCTA|ACTGGCAATCCTTTCATATGGACGCCCACT
TGGGTGGAGCGGGTGGGCACGAAAGTGGTT|ACACGCAACTATGGACCAAACCATTCGCAG
CGGGTGGGCACGACCGCACTGGCAATCCTT|AATGGGTGGAGCGGGTGGGCACGCAATGGG
GTCGGATATAGACTACTTACTGTGAATGGG|AGGAGGAGCACCGGGCATTTAATGACCTGA
TTACCAAATTCGAGTTAATAAGATGTACTG|CACTTTCGTGAACCTCAAGTAGGAGTGAAA
GGACGCCCACTCGACCCGGCGGGGACCACA|TGTTACATAATAGCTCGTCCTGTCTCGTGT
GACTCACAGAACCGTTAGTTGGGCACACGC|GGAGCGGGTGGGCACTACTGTGAATGGGTG
CGACCGCACTGGCAATCCTTTCATATGGAC|GCGGGTGGGCACGCAATGGGCGAATGTGTT
TTGCAGTGGGGGCCTAGGCCCCGGCCGGTC|GTCTACTCTTAGTTAAATGGGATCGGCTTT
CATGTAATTAACCCTGTAAATACCACGCTG|GTACTGTGAATGGGTGGAGCGGGTGGGCAC
TTTTTGGGTGCGGCTGTGTTCACACCTGTC|ACGGCTAATACTGTGAATGGGTGGAGCGGG
GAGCGGGTGGGCACGGCCCGAGCGCCCCGC|ACTGATCCTAACTGAGCGCTGTCAATTAGC
GGGTGGAGCGGGTGGGCACGGTGAATGGGT|TGATGAGTTTTATGTGAGGGGATGTGATAT
GTGCGGCTGTGTTCACACCTGTCTTTACTG|ATACTGTGAATGGGTGGAGCGGGTGGGCAC
TAACCCTGTAAATACCACGCTGTCGTCGAG|AATGGGTGGAGCGGGTGGGCACGCACGCTG
GGAGCACCGGGCATTTAATGACCTGATGAG|CTCACATGATCTCATCTTTGTGGAAGTTCC
GGCAACACAAGATGCCGGAGACCGTCTGTA|CGGGTGGGCACGCTTGCGTCTTGACTCACA
GTGGAGCGGGTGGGTACTGTGAATGGGTGG|AGCTTACTGTGAATGGGTGGAGCGGGTGGG
CCTAACTGAGCGCTGTCAATTAGCGGAACG|GGTGGGCACGCAGATAGGCTACTGTGCGTA
AGACCTTACTGTGAATGGGTGGAGCGGGTG|CGGAGACCGTCTGTATACAGCTTACTGTGA
GACCAAACCATTCGCAGTTTTTTCGCATCT|TGGGCACGGGCACGCTACACCCATGCGATC
TACTGTGAATGGGTGGAGCGGGTGGGCACG|CGCTGAGCAACACGTCAGTTAGTTTTGGGA
AGACCCAAAACACTCCCAAGCTGGGCTTCA|TGTAATTAACCCTGTAAATACCACGCTGTC
TCACAGAACCGTTAGTTGGGCACACGCAAC|GCGGGTGGGCACTACTGTGAATGGGTGGAG
GCGGGTGGGCACGCACGCTGCACTCACATG|ACGAAAGTGGTTCTGGCGTCGTTTGGCAGG
GGAGCGGGTGGGCACGGGCACGCTACACCC|CGAGCGCCCCGCGGAACAACTCCACATGCC
GAGCGGGTGGTACTGTGAATGGGTGGAGCG|ATGATGGCAAGGATGTCGTGTACTGTGAAT
GGCACGACTCGAACGTATGCTGTCAGTACT|TTGGGAAATGCGGCTCAGGAATTGGTTCAC
GGAAGCGCGTCTACTCTTAGTTAAATGGGA|ACACCGTGAGTACTGTGAATGGGTGGAGCG
TCGAGGAGGAGCACCGGGCATTTAATGACC|CGCTGCACTCACATGATCTCATCTTTGTGG
TGACTCACAGAACCGTTAGTTGGGCACACG|TGGAGCGGGTGGGCACTACTGTGAATGGGT
GTCTACTCTTAGTTAAATGGGATCGGCTTT|AGTACTGTGAATGGGTGGAGCGGGTGGGCA
GCCCCGCGGAACAACTCCACATGCCCGTAT|AATTAGCGGAACGTCCTAAGCCTGCAGTTT
CGCATCTTACCAAATTCGAGTTAATAAGAT|TGCGATCACTTTCGTGAACCTCAAGTAGGA
AGTTAAATGGGATCGGCTTTCTCACGGCTA|ATGGGTGGAGCGGGTGGGCACGACTCGAAC
GCCGGAGACCGTCTGTATACAGCTTACTGT|TTGCGTCTTGACTCACAGAACCGTTAGTTG
GCGGGTGGGCACGGGCACGCTACACCCATG|GCGCCCCGCGGAACAACTCCACATGCCCGT
ATGTAATTAACCCTGTAAATACCACGCTGT|TACTGTGAATGGGTGGAGCGGGTGGGCACG
GTCTATCAGTTAGTACTGTGAATGGGTGGA|CAGTGGGGGCCTAGGCCCCGGCCGGTCGTC
CTGTCTTTACTGTGAATGGGTGGAGCGGGT|GCGGGTGGGCACGACCGCACTGGCAATCCT
GGAGCGGGTGGGCACGGTGAATGGGTGGAG|GAGTTTTATGTGAGGGGATGTGATATATGT
ACCCAAAACACTCCCAAGCTGGGCTTCAAC|TAATTAACCCTGTAAATACCACGCTGTCGT
TACTGTGAATGGGTGGAGCGGGTGGGTACT|CCGTCTGTATACAGCTTACTGTGAATGGGT
CGTGAACCTCAAGTAGGAGTGAAAAGGACG|AGTTAGTACTGTGAATGGGTGGAGCGGGTG
CTCACATGATCTCATCTTTGTGGAAGTTCC|TTGGCAGGTCGGGGTTCACTGGCCTGTACT
GAACCTCAAGTAGGAGTGAAAAGGACGGCC|TAGTACTGTGAATGGGTGGAGCGGGTGGGC
TATGGACCAAACCATTCGCAGTTTTTTCGC|CGGGTGGGCACGGGCACGCTACACCCATGC
GATCTCATCTTTGTGGAAGTTCCACGAGAT|GTCGGGGTTCACTGGCCTGTACTGTGAATG
TGGTTCTGGCGTCGTTTGGCAGGTCGGGGT|CGCAGTTTTTTCGCATCTTACCAAATTCGA
ACTCGACCCGGCGGGGACCACACCGTGAGT|AATAGCTCGTCCTGTCTCGTGTGGGATGTC
ATGGGTGGAGCGGGTGGGCACGGCCCGAGC|AAATATCACTGATCCTAACTGAGCGCTGTC
GTACTGTGAATGGGTGGAGCGGGTGGGCAC|CTCAAGGGCAAATATCACTGATCCTAACTG
TGGACGCCCACTCGACCCGGCGGGGACCAC|GTGTTACATAATAGCTCGTCCTGTCTCGTG
GTGGAGCGGGTGGGCACGACGTTCTGTGGT|TCGTCTTTTTGGGTGCGGCTGTGTTCACAC
GGGCACGACCGCACTGGCAATCCTTTCATA|GTGGAGCGGGTGGGCACGCAATGGGCGAAT
GGCACGACCGCACTGGCAATCCTTTCATAT|TGGAGCGGGTGGGCACGCAATGGGCGAATG
TGTTCACACCTGTCTTTACTGTGAATGGGT|ATGGGTGGAGCGGGTGGGCACGACCGCACT
GGTGGGCACGGGCACGCTACACCCATGCGA|CCCCGCGGAACAACTCCACATGCCCGTATG
GGTGGAGCGGGTGGGCACGCTTGCGTCTTG|GGGTGGAGCGGGTGGTACTGTGAATGGGTG
CTGGCAATCCTTTCATATGGACGCCCACTC|GCACGCAATGGGCGAATGTGTTACATAATA
GCTGGGCTTCAACTGGTCGGATATAGACTA|ACCACGCTGTCGTCGAGGAGGAGCACCGGG
AACTCCACATGCCCGTATGGTCTATCAGTT|GTCCTAAGCCTGCAGTTTGCAGTGGGGGCC
GTACCCCGTGCTGCTCTATCATGTAATTAA|GAATGGGTGGAGCGGGTGGGTACTGTGAAT
CGGATATAGACTACTTACTGTGAATGGGTG|GAGGAGCACCGGGCATTTAATGACCTGATG
GGAGTGAAAAGGACGGCCAATGATGGCAAG|TGGGTGGAGCGGGTGGGCACGACGTTCTGT
AATATCACTGATCCTAACTGAGCGCTGTCA|ATGGGTGGAGCGGGTGGGCACGCAGATAGG
ATGGACGCCCACTCGACCCGGCGGGGACCA|TGTGTTACATAATAGCTCGTCCTGTCTCGT
TTACTGTGAATGGGTGGAGCGGGTGGGCAC|TTAGTTGGGCACACGCAACTATGGACCAAA
TCGTGAACCTCAAGTAGGAGTGAAAAGGAC|CAGTTAGTACTGTGAATGGGTGGAGCGGGT
CCCGTGCTGCTCTATCATGTAATTAACCCT|GGGTGGAGCGGGTGGGTACTGTGAATGGGT
GGAACAACTCCACATGCCCGTATGGTCTAT|GGAACGTCCTAAGCCTGCAGTTTGCAGTGG
GCAGGTCGGGGTTCACTGGCCTGTACTGTG|TACCAAATTCGAGTTAATAAGATGTACTGT
AAGTGGTTCTGGCGTCGTTTGGCAGGTCGG|ATTCGCAGTTTTTTCGCATCTTACCAAATT
GATATAGACTACTTACTGTGAATGGGTGGA|GGAGCACCGGGCATTTAATGACCTGATGAG
AATGGGTGGAGCGGGTGGGCACGGTGAATG|ACCTGATGAGTTTTATGTGAGGGGATGTGA
GAGCGGGTGGGCACGACTCGAACGTATGCT|CAGTTAGTTTTGGGAAATGCGGCTCAGGAA
TAATACTGTGAATGGGTGGAGCGGGTGGGC|ACGTATGCTGTCAGTACTGTGAATGGGTGG
CGGGTGGGCACGAAAGTGGTTCTGGCGTCG|TATGGACCAAACCATTCGCAGTTTTTTCGC
GTGCGTATATGCGTGGAAGCGCGTCTACTC|ACCCGGCGGGGACCACACCGTGAGTACTGT
GCTGTCAGTACTGTGAATGGGTGGAGCGGG|GAATTGGTTCACTGGTCTCTTATAGGACTG
TGTGAATGGGTGGAGCGGGTGGGCACGGTG|AATGACCTGATGAGTTTTATGTGAGGGGAT
TCTTGACTCACAGAACCGTTAGTTGGGCAC|GGGTGGAGCGGGTGGGCACTACTGTGAATG
GGAGCGGGTGGGCACGACGTACCCCGTGCT|ATGTCGAGACCTTACTGTGAATGGGTGGAG
TGGGTGGAGCGGGTGGGCACTACTGTGAAT|GTACTGTGAATGGGTGGAGCGGGTGGGCAC
ATATGTCGAGACCTTACTGTGAATGGGTGG|CAAGATGCCGGAGACCGTCTGTATACAGCT
GAATGGGTGGAGCGGGTGGGCACGGTGAAT|GACCTGATGAGTTTTATGTGAGGGGATGTG
CTACTGTGAATGGGTGGAGCGGGTGGGCAC|CGGGTGGGCACGGCCCGAGCGCCCCGCGGA
GGGTGGAGCGGGTGGGCACGACGTTCTGTG|GGTCGTCTTTTTGGGTGCGGCTGTGTTCAC
GCAAATATCACTGATCCTAACTGAGCGCTG|TGAATGGGTGGAGCGGGTGGGCACGCAGAT
GTTCTGGCGTCGTTTGGCAGGTCGGGGTTC|CAGTTTTTTCGCATCTTACCAAATTCGAGT
GGGCACGACGTACCCCGTGCTGCTCTATCA|CCTTACTGTGAATGGGTGGAGCGGGTGGGT
TCATGTAATTAACCCTGTAAATACCACGCT|GGTACTGTGAATGGGTGGAGCGGGTGGGCA
GTAGGAGTGAAAAGGACGGCCAATGATGGC|GAATGGGTGGAGCGGGTGGGCACGACGTTC
GCGGGTGGGCACGACTCGAACGTATGCTGT|GTTAGTTTTGGGAAATGCGGCTCAGGAATT
GAGTTAATAAGATGTACTGTGAATGGGTGG|ACCTCAAGTAGGAGTGAAAAGGACGGCCAA
GAATGGGTGGAGCGGGTGGGCACTACTGTG|CGTGTACTGTGAATGGGTGGAGCGGGTGGG
GGGTTCACTGGCCTGTACTGTGAATGGGTG|TCGAGTTAATAAGATGTACTGTGAATGGGT
TCAGTTAGTACTGTGAATGGGTGGAGCGGG|GGGGCCTAGGCCCCGGCCGGTCGTCTTTTT
GAAGTTCCACGAGATGCATCAGGGCAACAC|CCTGTACTGTGAATGGGTGGAGCGGGTGGG
AGGGGATGTGATATATGTCGAGACCTTACT|ATCAGGGCAACACAAGATGCCGGAGACCGT
CAAAACACTCCCAAGCTGGGCTTCAACTGG|TTAACCCTGTAAATACCACGCTGTCGTCGA
CCGCACTGGCAATCCTTTCATATGGACGCC|GGTGGGCACGCAATGGGCGAATGTGTTACA
AGCGGGTGGGTACTGTGAATGGGTGGAGCG|TACTGTGAATGGGTGGAGCGGGTGGGCACG
GTCGTGTACTGTGAATGGGTGGAGCGGGTG|CGGAGCTCAAGGGCAAATATCACTGATCCT
GTGGGCACGAAAGTGGTTCTGGCGTCGTTT|GGACCAAACCATTCGCAGTTTTTTCGCATC
TCTTTACTGTGAATGGGTGGAGCGGGTGGG|GGTGGGCACGACCGCACTGGCAATCCTTTC
CTGGGCTTCAACTGGTCGGATATAGACTAC|CCACGCTGTCGTCGAGGAGGAGCACCGGGC
CTAACTGAGCGCTGTCAATTAGCGGAACGT|GTGGGCACGCAGATAGGCTACTGTGCGTAT
TCGCAGTTTTTTCGCATCTTACCAAATTCG|ACGCTACACCCATGCGATCACTTTCGTGAA
CGGCGGGGACCACACCGTGAGTACTGTGAA|GTCCTGTCTCGTGTGGGATGTCGCTGAGCA
GGCCAATGATGGCAAGGATGTCGTGTACTG|GGGCACGACGTTCTGTGGTCGGAGCTCAAG
TACTCTTAGTTAAATGGGATCGGCTTTCTC|ACTGTGAATGGGTGGAGCGGGTGGGCACGA
ACTGTGAATGGGTGGAGCGGGTGGGCACGC|TACTGTGAATGGGTGGAGCGGGTGGTACTG
CTTAGTTAAATGGGATCGGCTTTCTCACGG|TGAATGGGTGGAGCGGGTGGGCACGACTCG
TCTTAGTTAAATGGGATCGGCTTTCTCACG|GTGAATGGGTGGAGCGGGTGGGCACGACTC
CTTACTGTGAATGGGTGGAGCGGGTGGGTA|GACCGTCTGTATACAGCTTACTGTGAATGG
CACGACGTTCTGTGGTCGGAGCTCAAGGGC|GCGGCTGTGTTCACACCTGTCTTTACTGTG
AAGGATGTCGTGTACTGTGAATGGGTGGAG|TGTGGTCGGAGCTCAAGGGCAAATATCACT
ATGCGTGGAAGCGCGTCTACTCTTAGTTAA|GGGACCACACCGTGAGTACTGTGAATGGGT
CCCAAGCTGGGCTTCAACTGGTCGGATATA|TAAATACCACGCTGTCGTCGAGGAGGAGCA
CCTGATGAGTTTTATGTGAGGGGATGTGAT|GGAAGTTCCACGAGATGCATCAGGGCAACA
AGCGGGTGGGCACGGTGAATGGGTGGAGCG|GTTTTATGTGAGGGGATGTGATATATGTCG
CCTCAAGTAGGAGTGAAAAGGACGGCCAAT|TACTGTGAATGGGTGGAGCGGGTGGGCACG
CGGGTGGGTACTGTGAATGGGTGGAGCGGG|CTGTGAATGGGTGGAGCGGGTGGGCACGAA
CGCTACACCCATGCGATCACTTTCGTGAAC|TCCACATGCCCGTATGGTCTATCAGTTAGT
GGTGGGCACGAAAGTGGTTCTGGCGTCGTT|TGGACCAAACCATTCGCAGTTTTTTCGCAT
ATCCTTTCATATGGACGCCCACTCGACCCG|AATGGGCGAATGTGTTACATAATAGCTCGT
ACGCAACTATGGACCAAACCATTCGCAGTT|GGTGGAGCGGGTGGGCACGGGCACGCTACA
GGGTGGGCACTACTGTGAATGGGTGGAGCG|TGGGTGGAGCGGGTGGGCACGGCCCGAGCG
GAGCGGGTGGGCACGCAGATAGGCTACTGT|GCAATCCTTTCATATGGACGCCCACTCGAC
TATCATGTAATTAACCCTGTAAATACCACG|TGGGTACTGTGAATGGGTGGAGCGGGTGGG
AATGGGTGGAGCGGGTGGGCACGACGTACC|GTGATATATGTCGAGACCTTACTGTGAATG
ATGTCGTGTACTGTGAATGGGTGGAGCGGG|GTCGGAGCTCAAGGGCAAATATCACTGATC
GAGACCGTCTGTATACAGCTTACTGTGAAT|GTCTTGACTCACAGAACCGTTAGTTGGGCA
GGGTGGAGCGGGTGGGCACGAAAGTGGTTC|CACGCAACTATGGACCAAACCATTCGCAGT
ACACGCAACTATGGACCAAACCATTCGCAG|TGGGTGGAGCGGGTGGGCACGGGCACGCTA
GAGCGCTGTCAATTAGCGGAACGTCCTAAG|ACGCAGATAGGCTACTGTGCGTATATGCGT
AGTTGTGGCCAGACCCAAAACACTCCCAAG|TGCTCTATCATGTAATTAACCCTGTAAATA
GAACGTATGCTGTCAGTACTGTGAATGGGT|CGGCTCAGGAATTGGTTCACTGGTCTCTTA
ACTGTGAATGGGTGGAGCGGGTGGTACTGT|GAAAAGGACGGCCAATGATGGCAAGGATGT
TGTGATATATGTCGAGACCTTACTGTGAAT|GCAACACAAGATGCCGGAGACCGTCTGTAT
TCGTCTTTTTGGGTGCGGCTGTGTTCACAC|TTCTCACGGCTAATACTGTGAATGGGTGGA
CCGGCCGGTCGTCTTTTTGGGTGCGGCTGT|GATCGGCTTTCTCACGGCTAATACTGTGAA
TTAAATGGGATCGGCTTTCTCACGGCTAAT|GGGTGGAGCGGGTGGGCACGACTCGAACGT
GTGAGGGGATGTGATATATGTCGAGACCTT|TGCATCAGGGCAACACAAGATGCCGGAGAC
CTTAAGCCTTTTCCGAAATTAAATACAGTT|GCGGGTGGGCACGACGTACCCCGTGCTGCT
CTGATGAGTTTTATGTGAGGGGATGTGATA|GAAGTTCCACGAGATGCATCAGGGCAACAC
TATGCTGTCAGTACTGTGAATGGGTGGAGC|CAGGAATTGGTTCACTGGTCTCTTATAGGA
TGAGTACTGTGAATGGGTGGAGCGGGTGGG|ATGTCGCTGAGCAACACGTCAGTTAGTTTT
AGTTTGCAGTGGGGGCCTAGGCCCCGGCCG|CGCGTCTACTCTTAGTTAAATGGGATCGGC
GTATATGCGTGGAAGCGCGTCTACTCTTAG|GGCGGGGACCACACCGTGAGTACTGTGAAT
AGCTTACTGTGAATGGGTGGAGCGGGTGGG|CCGTTAGTTGGGCACACGCAACTATGGACC
AATGGGTGGAGCGGGTGGGCACGGCCCGAG|CAAATATCACTGATCCTAACTGAGCGCTGT
GGACCAAACCATTCGCAGTTTTTTCGCATC|GTGGGCACGGGCACGCTACACCCATGCGAT
CACTTTCGTGAACCTCAAGTAGGAGTGAAA|TCTATCAGTTAGTACTGTGAATGGGTGGAG
GACTCGAACGTATGCTGTCAGTACTGTGAA|AAATGCGGCTCAGGAATTGGTTCACTGGTC
TGGCCTGTACTGTGAATGGGTGGAGCGGGT|ATAAGATGTACTGTGAATGGGTGGAGCGGG
TAGCGGAACGTCCTAAGCCTGCAGTTTGCA|ACTGTGCGTATATGCGTGGAAGCGCGTCTA
CACGGGCACGCTACACCCATGCGATCACTT|GGAACAACTCCACATGCCCGTATGGTCTAT
GGGTGGGCACGACGTACCCCGTGCTGCTCT|GAGACCTTACTGTGAATGGGTGGAGCGGGT
GGGCACGGGCACGCTACACCCATGCGATCA|CGCGGAACAACTCCACATGCCCGTATGGTC
ACTGAGCGCTGTCAATTAGCGGAACGTCCT|GGCACGCAGATAGGCTACTGTGCGTATATG
ATAGACTACTTACTGTGAATGGGTGGAGCG|GCACCGGGCATTTAATGACCTGATGAGTTT
TAGTTGGGCACACGCAACTATGGACCAAAC|TACTGTGAATGGGTGGAGCGGGTGGGCACG
TCTTAAGCCTTTTCCGAAATTAAATACAGT|AGCGGGTGGGCACGACGTACCCCGTGCTGC
GACCCAAAACACTCCCAAGCTGGGCTTCAA|GTAATTAACCCTGTAAATACCACGCTGTCG
CGTGTACTGTGAATGGGTGGAGCGGGTGGG|GAGCTCAAGGGCAAATATCACTGATCCTAA
AAGATGCCGGAGACCGTCTGTATACAGCTT|CACGCTTGCGTCTTGACTCACAGAACCGTT
CTAATACTGTGAATGGGTGGAGCGGGTGGG|AACGTATGCTGTCAGTACTGTGAATGGGTG
CGCCCCGCGGAACAACTCCACATGCCCGTA|CAATTAGCGGAACGTCCTAAGCCTGCAGTT
GTTCACTGGCCTGTACTGTGAATGGGTGGA|GAGTTAATAAGATGTACTGTGAATGGGTGG
GCAATCCTTTCATATGGACGCCCACTCGAC|CGCAATGGGCGAATGTGTTACATAATAGCT
ATCGGCTTTCTCACGGCTAATACTGTGAAT|GGGTGGGCACGACTCGAACGTATGCTGTCA
ACGCTGTCGTCGAGGAGGAGCACCGGGCAT|GGGCACGCACGCTGCACTCACATGATCTCA
ACTCACATGATCTCATCTTTGTGGAAGTTC|TTTGGCAGGTCGGGGTTCACTGGCCTGTAC
GCGTCTTGACTCACAGAACCGTTAGTTGGG|AATGGGTGGAGCGGGTGGGCACTACTGTGA
GGTGGGCACGACTCGAACGTATGCTGTCAG|AGTTTTGGGAAATGCGGCTCAGGAATTGGT
TTAGTTGGGCACACGCAACTATGGACCAAA|CTACTGTGAATGGGTGGAGCGGGTGGGCAC
CTTTACTGTGAATGGGTGGAGCGGGTGGGC|GTGGGCACGACCGCACTGGCAATCCTTTCA
CCCAAAACACTCCCAAGCTGGGCTTCAACT|AATTAACCCTGTAAATACCACGCTGTCGTC
TGTGAATGGGTGGAGCGGGTGGGCACGACC|GCTGTCAGTACTGTGAATGGGTGGAGCGGG
GTGGAGCGGGTGGTACTGTGAATGGGTGGA|CCAATGATGGCAAGGATGTCGTGTACTGTG
GAAAAGGACGGCCAATGATGGCAAGGATGT|GGAGCGGGTGGGCACGACGTTCTGTGGTCG
GGGCACGAAAGTGGTTCTGGCGTCGTTTGG|ACCAAACCATTCGCAGTTTTTTCGCATCTT
GGTGGGCACGACGTTCTGTGGTCGGAGCTC|TTGGGTGCGGCTGTGTTCACACCTGTCTTT
ATGGACCAAACCATTCGCAGTTTTTTCGCA|GGGTGGGCACGGGCACGCTACACCCATGCG
GGTACTGTGAATGGGTGGAGCGGGTGGGCA|ATGGGTGGAGCGGGTGGGCACGAAAGTGGT
TCTATCAGTTAGTACTGTGAATGGGTGGAG|AGTGGGGGCCTAGGCCCCGGCCGGTCGTCT
GCAACACAAGATGCCGGAGACCGTCTGTAT|GGGTGGGCACGCTTGCGTCTTGACTCACAG
GGAAGTTCCACGAGATGCATCAGGGCAACA|GCCTGTACTGTGAATGGGTGGAGCGGGTGG
AGCGGAACGTCCTAAGCCTGCAGTTTGCAG|CTGTGCGTATATGCGTGGAAGCGCGTCTAC
TGGGCTTCAACTGGTCGGATATAGACTACT|CACGCTGTCGTCGAGGAGGAGCACCGGGCA
TCGAGACCTTACTGTGAATGGGTGGAGCGG|TGCCGGAGACCGTCTGTATACAGCTTACTG
TGAATGGGTGGAGCGGGTGGGCACTACTGT|TCGTGTACTGTGAATGGGTGGAGCGGGTGG
ACCGGGCATTTAATGACCTGATGAGTTTTA|ATGATCTCATCTTTGTGGAAGTTCCACGAG
GTCGGAGCTCAAGGGCAAATATCACTGATC|ACCTGTCTTTACTGTGAATGGGTGGAGCGG
GCGGGTGGGCACGGTGAATGGGTGGAGCGG|TTTTATGTGAGGGGATGTGATATATGTCGA
TCCACGAGATGCATCAGGGCAACACAAGAT|ACTGTGAATGGGTGGAGCGGGTGGGCACGC
TGGGTGGAGCGGGTGGGCACGCACGCTGCA|GGGTGGGCACGAAAGTGGTTCTGGCGTCGT
ACAGTTGTGGCCAGACCCAAAACACTCCCA|GCTGCTCTATCATGTAATTAACCCTGTAAA
CCAAACCATTCGCAGTTTTTTCGCATCTTA|GGCACGGGCACGCTACACCCATGCGATCAC
GAGCGGGTGGGCACGGGCACGCTACACCCA|GAGCGCCCCGCGGAACAACTCCACATGCCC
CGAAAGTGGTTCTGGCGTCGTTTGGCAGGT|ACCATTCGCAGTTTTTTCGCATCTTACCAA
TTCGCAGTTTTTTCGCATCTTACCAAATTC|CACGCTACACCCATGCGATCACTTTCGTGA
GTGGTACTGTGAATGGGTGGAGCGGGTGGG|GCAAGGATGTCGTGTACTGTGAATGGGTGG
AATTAAATACAGTTGTGGCCAGACCCAAAA|TACCCCGTGCTGCTCTATCATGTAATTAAC
CCATGCGATCACTTTCGTGAACCTCAAGTA|CCCGTATGGTCTATCAGTTAGTACTGTGAA
CTGTGAATGGGTGGAGCGGGTGGGCACGCA|GTGGAGCGGGTGGGCACGAAAGTGGTTCTG
GGGCACGCTTGCGTCTTGACTCACAGAACC|TGGTACTGTGAATGGGTGGAGCGGGTGGGC
ACGTACCCCGTGCTGCTCTATCATGTAATT|GTGAATGGGTGGAGCGGGTGGGTACTGTGA
GGTCGGAGCTCAAGGGCAAATATCACTGAT|CACCTGTCTTTACTGTGAATGGGTGGAGCG
TGAAAAGGACGGCCAATGATGGCAAGGATG|TGGAGCGGGTGGGCACGACGTTCTGTGGTC
GTTTGGCAGGTCGGGGTTCACTGGCCTGTA|CATCTTACCAAATTCGAGTTAATAAGATGT
TTTGGCAGGTCGGGGTTCACTGGCCTGTAC|ATCTTACCAAATTCGAGTTAATAAGATGTA
GGCACACGCAACTATGGACCAAACCATTCG|GAATGGGTGGAGCGGGTGGGCACGGGCACG
GAGCGGGTGGGTACTGTGAATGGGTGGAGC|TTACTGTGAATGGGTGGAGCGGGTGGGCAC
CTCGACCCGGCGGGGACCACACCGTGAGTA|ATAGCTCGTCCTGTCTCGTGTGGGATGTCG
TGGTACTGTGAATGGGTGGAGCGGGTGGGC|CAAGGATGTCGTGTACTGTGAATGGGTGGA
TACAGTTGTGGCCAGACCCAAAACACTCCC|TGCTGCTCTATCATGTAATTAACCCTGTAA
GGCACTACTGTGAATGGGTGGAGCGGGTGG|GGAGCGGGTGGGCACGGCCCGAGCGCCCCG
AGGCTACTGTGCGTATATGCGTGGAAGCGC|CCCACTCGACCCGGCGGGGACCACACCGTG
AATACTGTGAATGGGTGGAGCGGGTGGGCA|CGTATGCTGTCAGTACTGTGAATGGGTGGA
CGCAACTATGGACCAAACCATTCGCAGTTT|GTGGAGCGGGTGGGCACGGGCACGCTACAC
AGTTCCACGAGATGCATCAGGGCAACACAA|TGTACTGTGAATGGGTGGAGCGGGTGGGCA
CTTCAACTGGTCGGATATAGACTACTTACT|CTGTCGTCGAGGAGGAGCACCGGGCATTTA
TGCGGCTGTGTTCACACCTGTCTTTACTGT|TACTGTGAATGGGTGGAGCGGGTGGGCACG
TACTGTGAATGGGTGGAGCGGGTGGGCACG|GGCCCCGGCCGGTCGTCTTTTTGGGTGCGG
GAATGGGTGGAGCGGGTGGGCACGCTTGCG|TGAATGGGTGGAGCGGGTGGTACTGTGAAT
ATATAGACTACTTACTGTGAATGGGTGGAG|GAGCACCGGGCATTTAATGACCTGATGAGT
TTACTGTGAATGGGTGGAGCGGGTGGGTAC|ACCGTCTGTATACAGCTTACTGTGAATGGG
CGTCTGTATACAGCTTACTGTGAATGGGTG|GACTCACAGAACCGTTAGTTGGGCACACGC
CTGTGCGTATATGCGTGGAAGCGCGTCTAC|CGACCCGGCGGGGACCACACCGTGAGTACT
CGACGTACCCCGTGCTGCTCTATCATGTAA|CTGTGAATGGGTGGAGCGGGTGGGTACTGT
GTACTGTGAATGGGTGGAGCGGGTGGGCAC|AGGATGTCGTGTACTGTGAATGGGTGGAGC
CGCGGAACAACTCCACATGCCCGTATGGTC|AGCGGAACGTCCTAAGCCTGCAGTTTGCAG
TGCGTCTTGACTCACAGAACCGTTAGTTGG|GAATGGGTGGAGCGGGTGGGCACTACTGTG
CAACACAAGATGCCGGAGACCGTCTGTATA|GGTGGGCACGCTTGCGTCTTGACTCACAGA
GGTCTATCAGTTAGTACTGTGAATGGGTGG|GCAGTGGGGGCCTAGGCCCCGGCCGGTCGT
TTTGGGTGCGGCTGTGTTCACACCTGTCTT|GGCTAATACTGTGAATGGGTGGAGCGGGTG
CGAGGAGGAGCACCGGGCATTTAATGACCT|GCTGCACTCACATGATCTCATCTTTGTGGA
TATGTGAGGGGATGTGATATATGTCGAGAC|AGATGCATCAGGGCAACACAAGATGCCGGA
GCTGCTCTATCATGTAATTAACCCTGTAAA|GAGCGGGTGGGTACTGTGAATGGGTGGAGC
AATGACCTGATGAGTTTTATGTGAGGGGAT|TTTGTGGAAGTTCCACGAGATGCATCAGGG
TCCACATGCCCGTATGGTCTATCAGTTAGT|CTAAGCCTGCAGTTTGCAGTGGGGGCCTAG
ATTAAATACAGTTGTGGCCAGACCCAAAAC|ACCCCGTGCTGCTCTATCATGTAATTAACC
CGTGAGTACTGTGAATGGGTGGAGCGGGTG|GGATGTCGCTGAGCAACACGTCAGTTAGTT
CGGTGAATGGGTGGAGCGGGTGGGCACGAC|GGGATGTGATATATGTCGAGACCTTACTGT
CAACTCCACATGCCCGTATGGTCTATCAGT|CGTCCTAAGCCTGCAGTTTGCAGTGGGGGC
GGGCACGGTGAATGGGTGGAGCGGGTGGGC|GTGAGGGGATGTGATATATGTCGAGACCTT
GTAATTAACCCTGTAAATACCACGCTGTCG|CTGTGAATGGGTGGAGCGGGTGGGCACGCA
CCGGTCGTCTTTTTGGGTGCGGCTGTGTTC|GGCTTTCTCACGGCTAATACTGTGAATGGG
ACACCGTGAGTACTGTGAATGGGTGGAGCG|TGTGGGATGTCGCTGAGCAACACGTCAGTT
CTCTTAGTTAAATGGGATCGGCTTTCTCAC|TGTGAATGGGTGGAGCGGGTGGGCACGACT
GTTTGCAGTGGGGGCCTAGGCCCCGGCCGG|GCGTCTACTCTTAGTTAAATGGGATCGGCT
GTGCTGCTCTATCATGTAATTAACCCTGTA|TGGAGCGGGTGGGTACTGTGAATGGGTGGA
ACTCACAGAACCGTTAGTTGGGCACACGCA|GAGCGGGTGGGCACTACTGTGAATGGGTGG
GAGTACTGTGAATGGGTGGAGCGGGTGGGC|TGTCGCTGAGCAACACGTCAGTTAGTTTTG
GCTGTCGTCGAGGAGGAGCACCGGGCATTT|GCACGCACGCTGCACTCACATGATCTCATC
GAATGGGTGGAGCGGGTGGGCACGACCGCA|GTCAGTACTGTGAATGGGTGGAGCGGGTGG
CATCTTTGTGGAAGTTCCACGAGATGCATC|GGTTCACTGGCCTGTACTGTGAATGGGTGG
TTTCCGAAATTAAATACAGTTGTGGCCAGA|CACGACGTACCCCGTGCTGCTCTATCATGT
TGTGGTCGGAGCTCAAGGGCAAATATCACT|TCACACCTGTCTTTACTGTGAATGGGTGGA
CATGCGATCACTTTCGTGAACCTCAAGTAG|CCGTATGGTCTATCAGTTAGTACTGTGAAT
GTGAATGGGTGGAGCGGGTGGGCACGGTGA|ATGACCTGATGAGTTTTATGTGAGGGGATG
CACCTGTCTTTACTGTGAATGGGTGGAGCG|GGAGCGGGTGGGCACGACCGCACTGGCAAT
GTGGGCACGGTGAATGGGTGGAGCGGGTGG|ATGTGAGGGGATGTGATATATGTCGAGACC
CGGAACGTCCTAAGCCTGCAGTTTGCAGTG|GTGCGTATATGCGTGGAAGCGCGTCTACTC
GACCACACCGTGAGTACTGTGAATGGGTGG|CTCGTGTGGGATGTCGCTGAGCAACACGTC
CTATCATGTAATTAACCCTGTAAATACCAC|GTGGGTACTGTGAATGGGTGGAGCGGGTGG
GCGGGTGGGCACGCTTGCGTCTTGACTCAC|AGCGGGTGGTACTGTGAATGGGTGGAGCGG
GATGAGTTTTATGTGAGGGGATGTGATATA|AGTTCCACGAGATGCATCAGGGCAACACAA
GAGCGGGTGGGCACGGTGAATGGGTGGAGC|AGTTTTATGTGAGGGGATGTGATATATGTC
ACTGGCCTGTACTGTGAATGGGTGGAGCGG|TAATAAGATGTACTGTGAATGGGTGGAGCG
CAGCTTACTGTGAATGGGTGGAGCGGGTGG|ACCGTTAGTTGGGCACACGCAACTATGGAC
TCAACTGGTCGGATATAGACTACTTACTGT|GTCGTCGAGGAGGAGCACCGGGCATTTAAT
GCGCGTCTACTCTTAGTTAAATGGGATCGG|CGTGAGTACTGTGAATGGGTGGAGCGGGTG
GCTACTGTGCGTATATGCGTGGAAGCGCGT|CACTCGACCCGGCGGGGACCACACCGTGAG
AACGTCCTAAGCCTGCAGTTTGCAGTGGGG|CGTATATGCGTGGAAGCGCGTCTACTCTTA
ATAAGATGTACTGTGAATGGGTGGAGCGGG|AGTAGGAGTGAAAAGGACGGCCAATGATGG
GGTGGAGCGGGTGGTACTGTGAATGGGTGG|GCCAATGATGGCAAGGATGTCGTGTACTGT
TGGAGCGGGTGGGCACGACGTACCCCGTGC|TATGTCGAGACCTTACTGTGAATGGGTGGA
GAGTTTTATGTGAGGGGATGTGATATATGT|TCCACGAGATGCATCAGGGCAACACAAGAT
GATGTGATATATGTCGAGACCTTACTGTGA|GGGCAACACAAGATGCCGGAGACCGTCTGT
GTCGAGACCTTACTGTGAATGGGTGGAGCG|ATGCCGGAGACCGTCTGTATACAGCTTACT
GGCACGGCCCGAGCGCCCCGCGGAACAACT|AACTGAGCGCTGTCAATTAGCGGAACGTCC
GTGGAGCGGGTGGGCACTACTGTGAATGGG|CTGTGAATGGGTGGAGCGGGTGGGCACGGC
TACTGTGAATGGGTGGAGCGGGTGGGCACG|GGGTGGGCACGGCCCGAGCGCCCCGCGGAA
CCCATGCGATCACTTTCGTGAACCTCAAGT|GCCCGTATGGTCTATCAGTTAGTACTGTGA
CTACTCTTAGTTAAATGGGATCGGCTTTCT|TACTGTGAATGGGTGGAGCGGGTGGGCACG
CGTCGTTTGGCAGGTCGGGGTTCACTGGCC|TTCGCATCTTACCAAATTCGAGTTAATAAG
GTGAGTACTGTGAATGGGTGGAGCGGGTGG|GATGTCGCTGAGCAACACGTCAGTTAGTTT
CGGGTGGGCACGACGTACCCCGTGCTGCTC|CGAGACCTTACTGTGAATGGGTGGAGCGGG
TAAGCCTGCAGTTTGCAGTGGGGGCCTAGG|GCGTGGAAGCGCGTCTACTCTTAGTTAAAT
TATACAGCTTACTGTGAATGGGTGGAGCGG|CAGAACCGTTAGTTGGGCACACGCAACTAT
CAATCCTTTCATATGGACGCCCACTCGACC|GCAATGGGCGAATGTGTTACATAATAGCTC
TACTTACTGTGAATGGGTGGAGCGGGTGGG|GGCATTTAATGACCTGATGAGTTTTATGTG
GTGGAGCGGGTGGGCACGACCGCACTGGCA|ACTGTGAATGGGTGGAGCGGGTGGGCACGC
GCCTAGGCCCCGGCCGGTCGTCTTTTTGGG|GTTAAATGGGATCGGCTTTCTCACGGCTAA
TGGCAAGGATGTCGTGTACTGTGAATGGGT|GTTCTGTGGTCGGAGCTCAAGGGCAAATAT
TCCTAACTGAGCGCTGTCAATTAGCGGAAC|GGGTGGGCACGCAGATAGGCTACTGTGCGT
CAACTATGGACCAAACCATTCGCAGTTTTT|GGAGCGGGTGGGCACGGGCACGCTACACCC
CCTTTTCCGAAATTAAATACAGTTGTGGCC|GGGCACGACGTACCCCGTGCTGCTCTATCA
GGGGACCACACCGTGAGTACTGTGAATGGG|TGTCTCGTGTGGGATGTCGCTGAGCAACAC
ATGCTGTCAGTACTGTGAATGGGTGGAGCG|AGGAATTGGTTCACTGGTCTCTTATAGGAC
TGGGATCGGCTTTCTCACGGCTAATACTGT|GAGCGGGTGGGCACGACTCGAACGTATGCT
CCAAAACACTCCCAAGCTGGGCTTCAACTG|ATTAACCCTGTAAATACCACGCTGTCGTCG
GAGCGGGTGGGCACGAAAGTGGTTCTGGCG|AACTATGGACCAAACCATTCGCAGTTTTTT
ATGATGGCAAGGATGTCGTGTACTGTGAAT|CGACGTTCTGTGGTCGGAGCTCAAGGGCAA
AGCGGGTGGTACTGTGAATGGGTGGAGCGG|TGATGGCAAGGATGTCGTGTACTGTGAATG
GTTCACACCTGTCTTTACTGTGAATGGGTG|TGGGTGGAGCGGGTGGGCACGACCGCACTG
GGGCAACACAAGATGCCGGAGACCGTCTGT|GCGGGTGGGCACGCTTGCGTCTTGACTCAC
CTGGTCGGATATAGACTACTTACTGTGAAT|TCGAGGAGGAGCACCGGGCATTTAATGACC
CTCAAGTAGGAGTGAAAAGGACGGCCAATG|ACTGTGAATGGGTGGAGCGGGTGGGCACGA
ACCGTTAGTTGGGCACACGCAACTATGGAC|GGCACTACTGTGAATGGGTGGAGCGGGTGG
GGTGGAGCGGGTGGGCACGGTGAATGGGTG|GATGAGTTTTATGTGAGGGGATGTGATATA
GACGGCCAATGATGGCAAGGATGTCGTGTA|GGTGGGCACGACGTTCTGTGGTCGGAGCTC
TATGGACGCCCACTCGACCCGGCGGGGACC|ATGTGTTACATAATAGCTCGTCCTGTCTCG
CTGTCGTCGAGGAGGAGCACCGGGCATTTA|CACGCACGCTGCACTCACATGATCTCATCT
TTACTGTGAATGGGTGGAGCGGGTGGGCAC|ATTTAATGACCTGATGAGTTTTATGTGAGG
GTCGAGGAGGAGCACCGGGCATTTAATGAC|ACGCTGCACTCACATGATCTCATCTTTGTG
AGATGCATCAGGGCAACACAAGATGCCGGA|AATGGGTGGAGCGGGTGGGCACGCTTGCGT
TGCCCGTATGGTCTATCAGTTAGTACTGTG|CTGCAGTTTGCAGTGGGGGCCTAGGCCCCG
GTCTGTATACAGCTTACTGTGAATGGGTGG|ACTCACAGAACCGTTAGTTGGGCACACGCA
CCCGAGCGCCCCGCGGAACAACTCCACATG|CGCTGTCAATTAGCGGAACGTCCTAAGCCT
GTGGCCAGACCCAAAACACTCCCAAGCTGG|CTATCATGTAATTAACCCTGTAAATACCAC
GGCGTCGTTTGGCAGGTCGGGGTTCACTGG|TTTTCGCATCTTACCAAATTCGAGTTAATA
TTTACTGTGAATGGGTGGAGCGGGTGGGCA|TGGGCACGACCGCACTGGCAATCCTTTCAT
GCACGCTGCACTCACATGATCTCATCTTTG|CTGGCGTCGTTTGGCAGGTCGGGGTTCACT
CTGCACTCACATGATCTCATCTTTGTGGAA|GTCGTTTGGCAGGTCGGGGTTCACTGGCCT
GCCTGTACTGTGAATGGGTGGAGCGGGTGG|AAGATGTACTGTGAATGGGTGGAGCGGGTG
CACGACTCGAACGTATGCTGTCAGTACTGT|GGGAAATGCGGCTCAGGAATTGGTTCACTG
TTAACCCTGTAAATACCACGCTGTCGTCGA|GAATGGGTGGAGCGGGTGGGCACGCACGCT
CGTCTTGACTCACAGAACCGTTAGTTGGGC|ATGGGTGGAGCGGGTGGGCACTACTGTGAA
TTCACACCTGTCTTTACTGTGAATGGGTGG|GGGTGGAGCGGGTGGGCACGACCGCACTGG
CACGCAGATAGGCTACTGTGCGTATATGCG|ATATGGACGCCCACTCGACCCGGCGGGGAC
GATGGCAAGGATGTCGTGTACTGTGAATGG|ACGTTCTGTGGTCGGAGCTCAAGGGCAAAT
TGATGAGTTTTATGTGAGGGGATGTGATAT|AAGTTCCACGAGATGCATCAGGGCAACACA
CACGCAACTATGGACCAAACCATTCGCAGT|GGGTGGAGCGGGTGGGCACGGGCACGCTAC
CCTGTACTGTGAATGGGTGGAGCGGGTGGG|AGATGTACTGTGAATGGGTGGAGCGGGTGG
GGTGGGCACGCACGCTGCACTCACATGATC|AAAGTGGTTCTGGCGTCGTTTGGCAGGTCG
GGGTGGAGCGGGTGGGCACGCTTGCGTCTT|TGGGTGGAGCGGGTGGTACTGTGAATGGGT
ATCAGGGCAACACAAGATGCCGGAGACCGT|TGGAGCGGGTGGGCACGCTTGCGTCTTGAC
CAAGCTGGGCTTCAACTGGTCGGATATAGA|AATACCACGCTGTCGTCGAGGAGGAGCACC
CCAATGATGGCAAGGATGTCGTGTACTGTG|GCACGACGTTCTGTGGTCGGAGCTCAAGGG
AAATGGGATCGGCTTTCTCACGGCTAATAC|GTGGAGCGGGTGGGCACGACTCGAACGTAT
GGCACGACGTTCTGTGGTCGGAGCTCAAGG|GTGCGGCTGTGTTCACACCTGTCTTTACTG
GCACCGGGCATTTAATGACCTGATGAGTTT|ACATGATCTCATCTTTGTGGAAGTTCCACG
GGAGCGGGTGGGCACGACTCGAACGTATGC|TCAGTTAGTTTTGGGAAATGCGGCTCAGGA
AGTTAGTACTGTGAATGGGTGGAGCGGGTG|GGCCTAGGCCCCGGCCGGTCGTCTTTTTGG
GCGGGTGGGTACTGTGAATGGGTGGAGCGG|ACTGTGAATGGGTGGAGCGGGTGGGCACGA
CCATTCGCAGTTTTTTCGCATCTTACCAAA|GGGCACGCTACACCCATGCGATCACTTTCG
CGGCCCGAGCGCCCCGCGGAACAACTCCAC|GAGCGCTGTCAATTAGCGGAACGTCCTAAG
ACTGTGAATGGGTGGAGCGGGTGGGCACGA|GCCCCGGCCGGTCGTCTTTTTGGGTGCGGC
GACCTTACTGTGAATGGGTGGAGCGGGTGG|GGAGACCGTCTGTATACAGCTTACTGTGAA
TCTGTATACAGCTTACTGTGAATGGGTGGA|CTCACAGAACCGTTAGTTGGGCACACGCAA
CCGTCTGTATACAGCTTACTGTGAATGGGT|TGACTCACAGAACCGTTAGTTGGGCACACG
CAGGGCAACACAAGATGCCGGAGACCGTCT|GAGCGGGTGGGCACGCTTGCGTCTTGACTC
AGTACTGTGAATGGGTGGAGCGGGTGGGCA|GTCGCTGAGCAACACGTCAGTTAGTTTTGG
TAGACTACTTACTGTGAATGGGTGGAGCGG|CACCGGGCATTTAATGACCTGATGAGTTTT
GGTGGGCACGCTTGCGTCTTGACTCACAGA|GGGTGGTACTGTGAATGGGTGGAGCGGGTG
AGCGGGTGGGCACGACCGCACTGGCAATCC|TGAATGGGTGGAGCGGGTGGGCACGCAATG
GCCTTTTCCGAAATTAAATACAGTTGTGGC|TGGGCACGACGTACCCCGTGCTGCTCTATC
GCAAGGATGTCGTGTACTGTGAATGGGTGG|TCTGTGGTCGGAGCTCAAGGGCAAATATCA
GGTGGGCACGGCCCGAGCGCCCCGCGGAAC|TCCTAACTGAGCGCTGTCAATTAGCGGAAC
GTCAGTACTGTGAATGGGTGGAGCGGGTGG|TTGGTTCACTGGTCTCTTATAGGACTGGTA
TGGAGCGGGTGGGCACGCACGCTGCACTCA|GGGCACGAAAGTGGTTCTGGCGTCGTTTGG
CGAGACCTTACTGTGAATGGGTGGAGCGGG|GCCGGAGACCGTCTGTATACAGCTTACTGT
TCAGGGCAACACAAGATGCCGGAGACCGTC|GGAGCGGGTGGGCACGCTTGCGTCTTGACT
GTTTTATGTGAGGGGATGTGATATATGTCG|CACGAGATGCATCAGGGCAACACAAGATGC
AAGTAGGAGTGAAAAGGACGGCCAATGATG|GTGAATGGGTGGAGCGGGTGGGCACGACGT
TGGCGTCGTTTGGCAGGTCGGGGTTCACTG|TTTTTCGCATCTTACCAAATTCGAGTTAAT
GCTCAAGGGCAAATATCACTGATCCTAACT|CTTTACTGTGAATGGGTGGAGCGGGTGGGC
TTTAATGACCTGATGAGTTTTATGTGAGGG|ATCTTTGTGGAAGTTCCACGAGATGCATCA
CTCAAGGGCAAATATCACTGATCCTAACTG|TTTACTGTGAATGGGTGGAGCGGGTGGGCA
ATGTGATATATGTCGAGACCTTACTGTGAA|GGCAACACAAGATGCCGGAGACCGTCTGTA
CGCGTCTACTCTTAGTTAAATGGGATCGGC|GTGAGTACTGTGAATGGGTGGAGCGGGTGG
TGGGTGCGGCTGTGTTCACACCTGTCTTTA|CTAATACTGTGAATGGGTGGAGCGGGTGGG
CACGCTACACCCATGCGATCACTTTCGTGA|ACTCCACATGCCCGTATGGTCTATCAGTTA
CTGTGAATGGGTGGAGCGGGTGGGCACGGG|GTGGGCACGGCCCGAGCGCCCCGCGGAACA
ACTGTGAATGGGTGGAGCGGGTGGGCACGG|GGTGGGCACGGCCCGAGCGCCCCGCGGAAC
TAACTGAGCGCTGTCAATTAGCGGAACGTC|TGGGCACGCAGATAGGCTACTGTGCGTATA
ATCTTTGTGGAAGTTCCACGAGATGCATCA|GTTCACTGGCCTGTACTGTGAATGGGTGGA
GTAAATACCACGCTGTCGTCGAGGAGGAGC|GGAGCGGGTGGGCACGCACGCTGCACTCAC
GGAGCGGGTGGGCACTACTGTGAATGGGTG|GTGAATGGGTGGAGCGGGTGGGCACGGCCC
GCACTCACATGATCTCATCTTTGTGGAAGT|CGTTTGGCAGGTCGGGGTTCACTGGCCTGT
GTGAACCTCAAGTAGGAGTGAAAAGGACGG|GTTAGTACTGTGAATGGGTGGAGCGGGTGG
CGAGTTAATAAGATGTACTGTGAATGGGTG|AACCTCAAGTAGGAGTGAAAAGGACGGCCA
GTGGGCACGACGTTCTGTGGTCGGAGCTCA|TGGGTGCGGCTGTGTTCACACCTGTCTTTA
CCTAAGCCTGCAGTTTGCAGTGGGGGCCTA|ATGCGTGGAAGCGCGTCTACTCTTAGTTAA
TGCTGCTCTATCATGTAATTAACCCTGTAA|GGAGCGGGTGGGTACTGTGAATGGGTGGAG
ACACTCCCAAGCTGGGCTTCAACTGGTCGG|CCCTGTAAATACCACGCTGTCGTCGAGGAG
TGTACTGTGAATGGGTGGAGCGGGTGGTAC|AGTGAAAAGGACGGCCAATGATGGCAAGGA
TGGGTGGAGCGGGTGGTACTGTGAATGGGT|CGGCCAATGATGGCAAGGATGTCGTGTACT
GCACGCACGCTGCACTCACATGATCTCATC|GGTTCTGGCGTCGTTTGGCAGGTCGGGGTT
GACTACTTACTGTGAATGGGTGGAGCGGGT|CCGGGCATTTAATGACCTGATGAGTTTTAT
GGTGGAGCGGGTGGGCACGGCCCGAGCGCC|TATCACTGATCCTAACTGAGCGCTGTCAAT
CCACGCTGTCGTCGAGGAGGAGCACCGGGC|GTGGGCACGCACGCTGCACTCACATGATCT
CACGACGTACCCCGTGCTGCTCTATCATGT|TACTGTGAATGGGTGGAGCGGGTGGGTACT
GTGATATATGTCGAGACCTTACTGTGAATG|CAACACAAGATGCCGGAGACCGTCTGTATA
GTGGAAGCGCGTCTACTCTTAGTTAAATGG|CCACACCGTGAGTACTGTGAATGGGTGGAG
GGTGGAGCGGGTGGGCACGAAAGTGGTTCT|ACGCAACTATGGACCAAACCATTCGCAGTT
AGCGCTGTCAATTAGCGGAACGTCCTAAGC|CGCAGATAGGCTACTGTGCGTATATGCGTG
AAGGACGGCCAATGATGGCAAGGATGTCGT|GCGGGTGGGCACGACGTTCTGTGGTCGGAG
GCGTATATGCGTGGAAGCGCGTCTACTCTT|CCGGCGGGGACCACACCGTGAGTACTGTGA
GGCAAGGATGTCGTGTACTGTGAATGGGTG|TTCTGTGGTCGGAGCTCAAGGGCAAATATC
GCGGGTGGGCACTACTGTGAATGGGTGGAG|AATGGGTGGAGCGGGTGGGCACGGCCCGAG
GGCCTAGGCCCCGGCCGGTCGTCTTTTTGG|AGTTAAATGGGATCGGCTTTCTCACGGCTA
GTGGGCACGGGCACGCTACACCCATGCGAT|CCCGCGGAACAACTCCACATGCCCGTATGG
TACCAAATTCGAGTTAATAAGATGTACTGT|ACTTTCGTGAACCTCAAGTAGGAGTGAAAA
GTGAATGGGTGGAGCGGGTGGGCACGCACG|GGAGCGGGTGGGCACGAAAGTGGTTCTGGC
CACCGTGAGTACTGTGAATGGGTGGAGCGG|GTGGGATGTCGCTGAGCAACACGTCAGTTA
CTGATCCTAACTGAGCGCTGTCAATTAGCG|GAGCGGGTGGGCACGCAGATAGGCTACTGT
CTTTCTCACGGCTAATACTGTGAATGGGTG|GGCACGACTCGAACGTATGCTGTCAGTACT
ATCCTAACTGAGCGCTGTCAATTAGCGGAA|CGGGTGGGCACGCAGATAGGCTACTGTGCG
TCGTTTGGCAGGTCGGGGTTCACTGGCCTG|CGCATCTTACCAAATTCGAGTTAATAAGAT
GCCAATGATGGCAAGGATGTCGTGTACTGT|GGCACGACGTTCTGTGGTCGGAGCTCAAGG
CGGGTGGTACTGTGAATGGGTGGAGCGGGT|ATGGCAAGGATGTCGTGTACTGTGAATGGG
CTTTCATATGGACGCCCACTCGACCCGGCG|GGGCGAATGTGTTACATAATAGCTCGTCCT
GCTTACTGTGAATGGGTGGAGCGGGTGGGC|CGTTAGTTGGGCACACGCAACTATGGACCA
TAATTAACCCTGTAAATACCACGCTGTCGT|TGTGAATGGGTGGAGCGGGTGGGCACGCAC
TGATCCTAACTGAGCGCTGTCAATTAGCGG|AGCGGGTGGGCACGCAGATAGGCTACTGTG
ACAGCTTACTGTGAATGGGTGGAGCGGGTG|AACCGTTAGTTGGGCACACGCAACTATGGA
TGTGAATGGGTGGAGCGGGTGGGCACTACT|TGTCGTGTACTGTGAATGGGTGGAGCGGGT
TGAATGGGTGGAGCGGGTGGGCACGGGCAC|GGCACGGCCCGAGCGCCCCGCGGAACAACT
TAAATACAGTTGTGGCCAGACCCAAAACAC|CCCGTGCTGCTCTATCATGTAATTAACCCT
TACTGTGAATGGGTGGAGCGGGTGGGCACG|TTTAATGACCTGATGAGTTTTATGTGAGGG
TGGAGCGGGTGGGTACTGTGAATGGGTGGA|GCTTACTGTGAATGGGTGGAGCGGGTGGGC
ACCCCGTGCTGCTCTATCATGTAATTAACC|ATGGGTGGAGCGGGTGGGTACTGTGAATGG
TCTATCATGTAATTAACCCTGTAAATACCA|GGTGGGTACTGTGAATGGGTGGAGCGGGTG
TGGGTGGAGCGGGTGGGCACGGCCCGAGCG|AATATCACTGATCCTAACTGAGCGCTGTCA
TGATCTCATCTTTGTGGAAGTTCCACGAGA|GGTCGGGGTTCACTGGCCTGTACTGTGAAT
GAGCTCAAGGGCAAATATCACTGATCCTAA|GTCTTTACTGTGAATGGGTGGAGCGGGTGG
ACCTTACTGTGAATGGGTGGAGCGGGTGGG|GAGACCGTCTGTATACAGCTTACTGTGAAT
GCATCTTACCAAATTCGAGTTAATAAGATG|GCGATCACTTTCGTGAACCTCAAGTAGGAG
GATCGGCTTTCTCACGGCTAATACTGTGAA|CGGGTGGGCACGACTCGAACGTATGCTGTC
TGTATACAGCTTACTGTGAATGGGTGGAGC|CACAGAACCGTTAGTTGGGCACACGCAACT
GGGTGGGCACGACGTTCTGTGGTCGGAGCT|TTTGGGTGCGGCTGTGTTCACACCTGTCTT
GCGGGGACCACACCGTGAGTACTGTGAATG|CCTGTCTCGTGTGGGATGTCGCTGAGCAAC
CGGAGACCGTCTGTATACAGCTTACTGTGA|GCGTCTTGACTCACAGAACCGTTAGTTGGG
GGGTGGAGCGGGTGGGCACGACTCGAACGT|CACGTCAGTTAGTTTTGGGAAATGCGGCTC
GAATGGGTGGAGCGGGTGGGCACGAAAGTG|GGCACACGCAACTATGGACCAAACCATTCG
TGCAGTTTGCAGTGGGGGCCTAGGCCCCGG|AAGCGCGTCTACTCTTAGTTAAATGGGATC
CATTTAATGACCTGATGAGTTTTATGTGAG|TCATCTTTGTGGAAGTTCCACGAGATGCAT
TGTGGCCAGACCCAAAACACTCCCAAGCTG|TCTATCATGTAATTAACCCTGTAAATACCA
GTACTGTGAATGGGTGGAGCGGGTGGGCAC|TGTACTGTGAATGGGTGGAGCGGGTGGTAC
GAGCGGGTGGGCACGCTTGCGTCTTGACTC|GGAGCGGGTGGTACTGTGAATGGGTGGAGC
TGGGTGGAGCGGGTGGGCACGACTCGAACG|ACACGTCAGTTAGTTTTGGGAAATGCGGCT
TAAATGGGATCGGCTTTCTCACGGCTAATA|GGTGGAGCGGGTGGGCACGACTCGAACGTA
ACCAAATTCGAGTTAATAAGATGTACTGTG|CTTTCGTGAACCTCAAGTAGGAGTGAAAAG
ACGAAAGTGGTTCTGGCGTCGTTTGGCAGG|AACCATTCGCAGTTTTTTCGCATCTTACCA
TTTCGCATCTTACCAAATTCGAGTTAATAA|CCATGCGATCACTTTCGTGAACCTCAAGTA
CTAGGCCCCGGCCGGTCGTCTTTTTGGGTG|TAAATGGGATCGGCTTTCTCACGGCTAATA
ATGCCGGAGACCGTCTGTATACAGCTTACT|GCTTGCGTCTTGACTCACAGAACCGTTAGT
CATTCGCAGTTTTTTCGCATCTTACCAAAT|GGCACGCTACACCCATGCGATCACTTTCGT
GAGCGGGTGGGCACGACGTTCTGTGGTCGG|TCTTTTTGGGTGCGGCTGTGTTCACACCTG
GGCACGCTACACCCATGCGATCACTTTCGT|CAACTCCACATGCCCGTATGGTCTATCAGT
ATGGGTGGAGCGGGTGGGTACTGTGAATGG|ATACAGCTTACTGTGAATGGGTGGAGCGGG
CTGCAGTTTGCAGTGGGGGCCTAGGCCCCG|GAAGCGCGTCTACTCTTAGTTAAATGGGAT
CACGCTGCACTCACATGATCTCATCTTTGT|TGGCGTCGTTTGGCAGGTCGGGGTTCACTG
TGCGATCACTTTCGTGAACCTCAAGTAGGA|GTATGGTCTATCAGTTAGTACTGTGAATGG
CACAGAACCGTTAGTTGGGCACACGCAACT|CGGGTGGGCACTACTGTGAATGGGTGGAGC
CGCACTGGCAATCCTTTCATATGGACGCCC|GTGGGCACGCAATGGGCGAATGTGTTACAT
ACGACTCGAACGTATGCTGTCAGTACTGTG|GGAAATGCGGCTCAGGAATTGGTTCACTGG
TTAATAAGATGTACTGTGAATGGGTGGAGC|TCAAGTAGGAGTGAAAAGGACGGCCAATGA
GGAGGAGCACCGGGCATTTAATGACCTGAT|GCACTCACATGATCTCATCTTTGTGGAAGT
TCGGATATAGACTACTTACTGTGAATGGGT|GGAGGAGCACCGGGCATTTAATGACCTGAT
CTCACGGCTAATACTGTGAATGGGTGGAGC|CGACTCGAACGTATGCTGTCAGTACTGTGA
CTGTGAATGGGTGGAGCGGGTGGTACTGTG|AAAAGGACGGCCAATGATGGCAAGGATGTC
GTGGTTCTGGCGTCGTTTGGCAGGTCGGGG|TCGCAGTTTTTTCGCATCTTACCAAATTCG
CACTGATCCTAACTGAGCGCTGTCAATTAG|TGGAGCGGGTGGGCACGCAGATAGGCTACT
GCGTCTACTCTTAGTTAAATGGGATCGGCT|TGAGTACTGTGAATGGGTGGAGCGGGTGGG
CGAACGTATGCTGTCAGTACTGTGAATGGG|GCGGCTCAGGAATTGGTTCACTGGTCTCTT
CTACACCCATGCGATCACTTTCGTGAACCT|CACATGCCCGTATGGTCTATCAGTTAGTAC
GTATGGTCTATCAGTTAGTACTGTGAATGG|GTTTGCAGTGGGGGCCTAGGCCCCGGCCGG
ACGTCCTAAGCCTGCAGTTTGCAGTGGGGG|GTATATGCGTGGAAGCGCGTCTACTCTTAG
TGTCTTTACTGTGAATGGGTGGAGCGGGTG|CGGGTGGGCACGACCGCACTGGCAATCCTT
TGGGTGGAGCGGGTGGGTACTGTGAATGGG|TACAGCTTACTGTGAATGGGTGGAGCGGGT
CATGCCCGTATGGTCTATCAGTTAGTACTG|GCCTGCAGTTTGCAGTGGGGGCCTAGGCCC
GGCAATCCTTTCATATGGACGCCCACTCGA|ACGCAATGGGCGAATGTGTTACATAATAGC
GGGCATTTAATGACCTGATGAGTTTTATGT|ATCTCATCTTTGTGGAAGTTCCACGAGATG
CAGTGGGGGCCTAGGCCCCGGCCGGTCGTC|TACTCTTAGTTAAATGGGATCGGCTTTCTC
AGTGGTTCTGGCGTCGTTTGGCAGGTCGGG|TTCGCAGTTTTTTCGCATCTTACCAAATTC
TGGGCACGAAAGTGGTTCTGGCGTCGTTTG|GACCAAACCATTCGCAGTTTTTTCGCATCT
TCTGTGGTCGGAGCTCAAGGGCAAATATCA|GTTCACACCTGTCTTTACTGTGAATGGGTG
CAGTTTGCAGTGGGGGCCTAGGCCCCGGCC|GCGCGTCTACTCTTAGTTAAATGGGATCGG
CTACTTACTGTGAATGGGTGGAGCGGGTGG|GGGCATTTAATGACCTGATGAGTTTTATGT
ATATCACTGATCCTAACTGAGCGCTGTCAA|TGGGTGGAGCGGGTGGGCACGCAGATAGGC
ACTACTTACTGTGAATGGGTGGAGCGGGTG|CGGGCATTTAATGACCTGATGAGTTTTATG
CTGTCAGTACTGTGAATGGGTGGAGCGGGT|AATTGGTTCACTGGTCTCTTATAGGACTGG
GGAGCGGGTGGTACTGTGAATGGGTGGAGC|AATGATGGCAAGGATGTCGTGTACTGTGAA
GGTGGGTACTGTGAATGGGTGGAGCGGGTG|GTGAATGGGTGGAGCGGGTGGGCACGAAAG
TGTGAATGGGTGGAGCGGGTGGGCACGCAG|ACGACCGCACTGGCAATCCTTTCATATGGA
GCACGGTGAATGGGTGGAGCGGGTGGGCAC|GAGGGGATGTGATATATGTCGAGACCTTAC
TTATGTGAGGGGATGTGATATATGTCGAGA|GAGATGCATCAGGGCAACACAAGATGCCGG
GGTGAATGGGTGGAGCGGGTGGGCACGACG|GGATGTGATATATGTCGAGACCTTACTGTG
CTGTGAATGGGTGGAGCGGGTGGGCACGAC|TGCTGTCAGTACTGTGAATGGGTGGAGCGG
TGAGTTTTATGTGAGGGGATGTGATATATG|TTCCACGAGATGCATCAGGGCAACACAAGA
TCTTTGTGGAAGTTCCACGAGATGCATCAG|TTCACTGGCCTGTACTGTGAATGGGTGGAG
ATATGCGTGGAAGCGCGTCTACTCTTAGTT|CGGGGACCACACCGTGAGTACTGTGAATGG
GTGGTCGGAGCTCAAGGGCAAATATCACTG|CACACCTGTCTTTACTGTGAATGGGTGGAG
GTGGAGCGGGTGGGCACGAAAGTGGTTCTG|CGCAACTATGGACCAAACCATTCGCAGTTT
GGGTGGAGCGGGTGGGCACGACCGCACTGG|GTACTGTGAATGGGTGGAGCGGGTGGGCAC
ATCTCATCTTTGTGGAAGTTCCACGAGATG|TCGGGGTTCACTGGCCTGTACTGTGAATGG
GCACGCTTGCGTCTTGACTCACAGAACCGT|GTACTGTGAATGGGTGGAGCGGGTGGGCAC
TTTTTTCGCATCTTACCAAATTCGAGTTAA|CACCCATGCGATCACTTTCGTGAACCTCAA
TAAATACCACGCTGTCGTCGAGGAGGAGCA|GAGCGGGTGGGCACGCACGCTGCACTCACA
TGTCGTCGAGGAGGAGCACCGGGCATTTAA|ACGCACGCTGCACTCACATGATCTCATCTT
TCTACTCTTAGTTAAATGGGATCGGCTTTC|GTACTGTGAATGGGTGGAGCGGGTGGGCAC
TGAGCGCTGTCAATTAGCGGAACGTCCTAA|CACGCAGATAGGCTACTGTGCGTATATGCG
CTGGCGTCGTTTGGCAGGTCGGGGTTCACT|TTTTTTCGCATCTTACCAAATTCGAGTTAA
GGGTGGGCACGCAGATAGGCTACTGTGCGT|TCCTTTCATATGGACGCCCACTCGACCCGG
GCATCAGGGCAACACAAGATGCCGGAGACC|GGTGGAGCGGGTGGGCACGCTTGCGTCTTG
GGCTGTGTTCACACCTGTCTTTACTGTGAA|TGTGAATGGGTGGAGCGGGTGGGCACGACC
ACTTACTGTGAATGGGTGGAGCGGGTGGGC|GCATTTAATGACCTGATGAGTTTTATGTGA
CCTTACTGTGAATGGGTGGAGCGGGTGGGT|AGACCGTCTGTATACAGCTTACTGTGAATG
GCTGTGTTCACACCTGTCTTTACTGTGAAT|GTGAATGGGTGGAGCGGGTGGGCACGACCG
CTGTGTTCACACCTGTCTTTACTGTGAATG|TGAATGGGTGGAGCGGGTGGGCACGACCGC
GTGGAGCGGGTGGGCACGACTCGAACGTAT|CGTCAGTTAGTTTTGGGAAATGCGGCTCAG
GGGTGGAGCGGGTGGGCACGGCCCGAGCGC|ATATCACTGATCCTAACTGAGCGCTGTCAA
CTATCAGTTAGTACTGTGAATGGGTGGAGC|GTGGGGGCCTAGGCCCCGGCCGGTCGTCTT
TCTTTTTGGGTGCGGCTGTGTTCACACCTG|TCACGGCTAATACTGTGAATGGGTGGAGCG
TCAAGGGCAAATATCACTGATCCTAACTGA|TTACTGTGAATGGGTGGAGCGGGTGGGCAC
TCTGGCGTCGTTTGGCAGGTCGGGGTTCAC|GTTTTTTCGCATCTTACCAAATTCGAGTTA
ACACCCATGCGATCACTTTCGTGAACCTCA|CATGCCCGTATGGTCTATCAGTTAGTACTG
GGTTCTGGCGTCGTTTGGCAGGTCGGGGTT|GCAGTTTTTTCGCATCTTACCAAATTCGAG
GCTAATACTGTGAATGGGTGGAGCGGGTGG|GAACGTATGCTGTCAGTACTGTGAATGGGT
GAATGGGTGGAGCGGGTGGGCACGGGCACG|GCACGGCCCGAGCGCCCCGCGGAACAACTC
ACGCTGCACTCACATGATCTCATCTTTGTG|GGCGTCGTTTGGCAGGTCGGGGTTCACTGG
GTGAATGGGTGGAGCGGGTGGGCACGACGT|CCGGCCGGTCGTCTTTTTGGGTGCGGCTGT
CACGCTTGCGTCTTGACTCACAGAACCGTT|TACTGTGAATGGGTGGAGCGGGTGGGCACT
TGGGTGGAGCGGGTGGGCACGGTGAATGGG|CTGATGAGTTTTATGTGAGGGGATGTGATA
AGGAGCACCGGGCATTTAATGACCTGATGA|ACTCACATGATCTCATCTTTGTGGAAGTTC
TAGGAGTGAAAAGGACGGCCAATGATGGCA|AATGGGTGGAGCGGGTGGGCACGACGTTCT
TATATGTCGAGACCTTACTGTGAATGGGTG|ACAAGATGCCGGAGACCGTCTGTATACAGC
AGCACCGGGCATTTAATGACCTGATGAGTT|CACATGATCTCATCTTTGTGGAAGTTCCAC
ACCAAACCATTCGCAGTTTTTTCGCATCTT|GGGCACGGGCACGCTACACCCATGCGATCA
GCACGAAAGTGGTTCTGGCGTCGTTTGGCA|CAAACCATTCGCAGTTTTTTCGCATCTTAC
TTTGTGGAAGTTCCACGAGATGCATCAGGG|CACTGGCCTGTACTGTGAATGGGTGGAGCG
CGCCCACTCGACCCGGCGGGGACCACACCG|TACATAATAGCTCGTCCTGTCTCGTGTGGG
TAGTTAAATGGGATCGGCTTTCTCACGGCT|AATGGGTGGAGCGGGTGGGCACGACTCGAA
ACTACTGTGAATGGGTGGAGCGGGTGGGCA|GCGGGTGGGCACGGCCCGAGCGCCCCGCGG
AAATATCACTGATCCTAACTGAGCGCTGTC|AATGGGTGGAGCGGGTGGGCACGCAGATAG
CTTTCGTGAACCTCAAGTAGGAGTGAAAAG|TATCAGTTAGTACTGTGAATGGGTGGAGCG
AAACCATTCGCAGTTTTTTCGCATCTTACC|CACGGGCACGCTACACCCATGCGATCACTT
GTCTTTTTGGGTGCGGCTGTGTTCACACCT|CTCACGGCTAATACTGTGAATGGGTGGAGC
AATACCACGCTGTCGTCGAGGAGGAGCACC|GCGGGTGGGCACGCACGCTGCACTCACATG
GTTGTGGCCAGACCCAAAACACTCCCAAGC|GCTCTATCATGTAATTAACCCTGTAAATAC
TGTACTGTGAATGGGTGGAGCGGGTGGGCA|ATGTACTGTGAATGGGTGGAGCGGGTGGTA
CGGCCAATGATGGCAAGGATGTCGTGTACT|TGGGCACGACGTTCTGTGGTCGGAGCTCAA
ATGGGTGGAGCGGGTGGGCACGGGCACGCT|ACGGCCCGAGCGCCCCGCGGAACAACTCCA
ACATGCCCGTATGGTCTATCAGTTAGTACT|AGCCTGCAGTTTGCAGTGGGGGCCTAGGCC
ACGTATGCTGTCAGTACTGTGAATGGGTGG|GCTCAGGAATTGGTTCACTGGTCTCTTATA
GAAATTAAATACAGTTGTGGCCAGACCCAA|CGTACCCCGTGCTGCTCTATCATGTAATTA
TGGAGCGGGTGGGCACGAAAGTGGTTCTGG|GCAACTATGGACCAAACCATTCGCAGTTTT
GGGCACGACTCGAACGTATGCTGTCAGTAC|TTTGGGAAATGCGGCTCAGGAATTGGTTCA
GAATGGGTGGAGCGGGTGGGCACGGCCCGA|GCAAATATCACTGATCCTAACTGAGCGCTG
TGTGAATGGGTGGAGCGGGTGGGCACGCAC|TGGAGCGGGTGGGCACGAAAGTGGTTCTGG
CAATGATGGCAAGGATGTCGTGTACTGTGA|CACGACGTTCTGTGGTCGGAGCTCAAGGGC
GGGGTTCACTGGCCTGTACTGTGAATGGGT|TTCGAGTTAATAAGATGTACTGTGAATGGG
ATACCACGCTGTCGTCGAGGAGGAGCACCG|CGGGTGGGCACGCACGCTGCACTCACATGA
CAGTTTTTTCGCATCTTACCAAATTCGAGT|CTACACCCATGCGATCACTTTCGTGAACCT
ATTAGCGGAACGTCCTAAGCCTGCAGTTTG|CTACTGTGCGTATATGCGTGGAAGCGCGTC
ACACAAGATGCCGGAGACCGTCTGTATACA|TGGGCACGCTTGCGTCTTGACTCACAGAAC
TCGTGTACTGTGAATGGGTGGAGCGGGTGG|GGAGCTCAAGGGCAAATATCACTGATCCTA
ATACAGTTGTGGCCAGACCCAAAACACTCC|GTGCTGCTCTATCATGTAATTAACCCTGTA
TGGGTGGAGCGGGTGGGCACGCAGATAGGC|GCACTGGCAATCCTTTCATATGGACGCCCA
TTGGGCACACGCAACTATGGACCAAACCAT|TGTGAATGGGTGGAGCGGGTGGGCACGGGC
GGAGCGGGTGGGCACGAAAGTGGTTCTGGC|CAACTATGGACCAAACCATTCGCAGTTTTT
TTGGCAGGTCGGGGTTCACTGGCCTGTACT|TCTTACCAAATTCGAGTTAATAAGATGTAC
CACATGATCTCATCTTTGTGGAAGTTCCAC|GGCAGGTCGGGGTTCACTGGCCTGTACTGT
CGCTGCACTCACATGATCTCATCTTTGTGG|GCGTCGTTTGGCAGGTCGGGGTTCACTGGC
AGTGGGGGCCTAGGCCCCGGCCGGTCGTCT|ACTCTTAGTTAAATGGGATCGGCTTTCTCA
TGAATGGGTGGAGCGGGTGGGCACGACGTT|CGGCCGGTCGTCTTTTTGGGTGCGGCTGTG
CTCACAGAACCGTTAGTTGGGCACACGCAA|AGCGGGTGGGCACTACTGTGAATGGGTGGA
TGAATGGGTGGAGCGGGTGGGCACGACGTA|ATGTGATATATGTCGAGACCTTACTGTGAA
CCGAGCGCCCCGCGGAACAACTCCACATGC|GCTGTCAATTAGCGGAACGTCCTAAGCCTG
GCGCTGTCAATTAGCGGAACGTCCTAAGCC|GCAGATAGGCTACTGTGCGTATATGCGTGG
TCACTGATCCTAACTGAGCGCTGTCAATTA|GTGGAGCGGGTGGGCACGCAGATAGGCTAC
TGGTCTATCAGTTAGTACTGTGAATGGGTG|TGCAGTGGGGGCCTAGGCCCCGGCCGGTCG
AGGACGGCCAATGATGGCAAGGATGTCGTG|CGGGTGGGCACGACGTTCTGTGGTCGGAGC
CCACTCGACCCGGCGGGGACCACACCGTGA|ATAATAGCTCGTCCTGTCTCGTGTGGGATG
TCAAGTAGGAGTGAAAAGGACGGCCAATGA|CTGTGAATGGGTGGAGCGGGTGGGCACGAC
TTTTTCGCATCTTACCAAATTCGAGTTAAT|ACCCATGCGATCACTTTCGTGAACCTCAAG
ATGATCTCATCTTTGTGGAAGTTCCACGAG|AGGTCGGGGTTCACTGGCCTGTACTGTGAA
ACCCATGCGATCACTTTCGTGAACCTCAAG|TGCCCGTATGGTCTATCAGTTAGTACTGTG
ATGTACTGTGAATGGGTGGAGCGGGTGGTA|GAGTGAAAAGGACGGCCAATGATGGCAAGG
GGCCTGTACTGTGAATGGGTGGAGCGGGTG|TAAGATGTACTGTGAATGGGTGGAGCGGGT
TTAGCGGAACGTCCTAAGCCTGCAGTTTGC|TACTGTGCGTATATGCGTGGAAGCGCGTCT
AAGCCTGCAGTTTGCAGTGGGGGCCTAGGC|CGTGGAAGCGCGTCTACTCTTAGTTAAATG
GCACTGGCAATCCTTTCATATGGACGCCCA|TGGGCACGCAATGGGCGAATGTGTTACATA
GGACGGCCAATGATGGCAAGGATGTCGTGT|GGGTGGGCACGACGTTCTGTGGTCGGAGCT
TGAATGGGTGGAGCGGGTGGGCACGACTCG|AGCAACACGTCAGTTAGTTTTGGGAAATGC
ACGGGCACGCTACACCCATGCGATCACTTT|GAACAACTCCACATGCCCGTATGGTCTATC
AGTTGGGCACACGCAACTATGGACCAAACC|ACTGTGAATGGGTGGAGCGGGTGGGCACGG
TCGAACGTATGCTGTCAGTACTGTGAATGG|TGCGGCTCAGGAATTGGTTCACTGGTCTCT
GGGTGGAGCGGGTGGGTACTGTGAATGGGT|ACAGCTTACTGTGAATGGGTGGAGCGGGTG
AATAAGATGTACTGTGAATGGGTGGAGCGG|AAGTAGGAGTGAAAAGGACGGCCAATGATG
AGCGGGTGGGCACGCAGATAGGCTACTGTG|CAATCCTTTCATATGGACGCCCACTCGACC
TACTGTGAATGGGTGGAGCGGGTGGGCACT|GGATGTCGTGTACTGTGAATGGGTGGAGCG
TTAGTACTGTGAATGGGTGGAGCGGGTGGG|CCTAGGCCCCGGCCGGTCGTCTTTTTGGGT
AGGCCCCGGCCGGTCGTCTTTTTGGGTGCG|AATGGGATCGGCTTTCTCACGGCTAATACT
TGAACCTCAAGTAGGAGTGAAAAGGACGGC|TTAGTACTGTGAATGGGTGGAGCGGGTGGG
CCTAGGCCCCGGCCGGTCGTCTTTTTGGGT|TTAAATGGGATCGGCTTTCTCACGGCTAAT
ACTGGTCGGATATAGACTACTTACTGTGAA|GTCGAGGAGGAGCACCGGGCATTTAATGAC
GGCACGAAAGTGGTTCTGGCGTCGTTTGGC|CCAAACCATTCGCAGTTTTTTCGCATCTTA
GAACCGTTAGTTGGGCACACGCAACTATGG|TGGGCACTACTGTGAATGGGTGGAGCGGGT
ACTGTGAATGGGTGGAGCGGGTGGGTACTG|CGTCTGTATACAGCTTACTGTGAATGGGTG
AATGGGTGGAGCGGGTGGTACTGTGAATGG|GACGGCCAATGATGGCAAGGATGTCGTGTA
GGCACGACGTACCCCGTGCTGCTCTATCAT|CTTACTGTGAATGGGTGGAGCGGGTGGGTA
CGTACCCCGTGCTGCTCTATCATGTAATTA|TGAATGGGTGGAGCGGGTGGGTACTGTGAA
ATCAGTTAGTACTGTGAATGGGTGGAGCGG|GGGGGCCTAGGCCCCGGCCGGTCGTCTTTT
GTGGGCACGCAGATAGGCTACTGTGCGTAT|CTTTCATATGGACGCCCACTCGACCCGGCG
TCTCATCTTTGTGGAAGTTCCACGAGATGC|CGGGGTTCACTGGCCTGTACTGTGAATGGG
TTGACTCACAGAACCGTTAGTTGGGCACAC|GTGGAGCGGGTGGGCACTACTGTGAATGGG
TGCGTATATGCGTGGAAGCGCGTCTACTCT|CCCGGCGGGGACCACACCGTGAGTACTGTG
TGGGTGGAGCGGGTGGGCACGACCGCACTG|AGTACTGTGAATGGGTGGAGCGGGTGGGCA
GCCCACTCGACCCGGCGGGGACCACACCGT|ACATAATAGCTCGTCCTGTCTCGTGTGGGA
CTCATCTTTGTGGAAGTTCCACGAGATGCA|GGGGTTCACTGGCCTGTACTGTGAATGGGT
TTCAACTGGTCGGATATAGACTACTTACTG|TGTCGTCGAGGAGGAGCACCGGGCATTTAA
CCTGTAAATACCACGCTGTCGTCGAGGAGG|GGTGGAGCGGGTGGGCACGCACGCTGCACT
TCGACCCGGCGGGGACCACACCGTGAGTAC|TAGCTCGTCCTGTCTCGTGTGGGATGTCGC
GTTTTTTCGCATCTTACCAAATTCGAGTTA|ACACCCATGCGATCACTTTCGTGAACCTCA
GTGGAGCGGGTGGGCACGACGTACCCCGTG|ATATGTCGAGACCTTACTGTGAATGGGTGG
ACAACTCCACATGCCCGTATGGTCTATCAG|ACGTCCTAAGCCTGCAGTTTGCAGTGGGGG
GGGTGGAGCGGGTGGGCACGACGTACCCCG|ATATATGTCGAGACCTTACTGTGAATGGGT
TCAATTAGCGGAACGTCCTAAGCCTGCAGT|AGGCTACTGTGCGTATATGCGTGGAAGCGC
CAAACCATTCGCAGTTTTTTCGCATCTTAC|GCACGGGCACGCTACACCCATGCGATCACT
ATGCCCGTATGGTCTATCAGTTAGTACTGT|CCTGCAGTTTGCAGTGGGGGCCTAGGCCCC
GGCCCCGGCCGGTCGTCTTTTTGGGTGCGG|ATGGGATCGGCTTTCTCACGGCTAATACTG
GGCTTCAACTGGTCGGATATAGACTACTTA|CGCTGTCGTCGAGGAGGAGCACCGGGCATT
AATGGGTGGAGCGGGTGGGCACGACTCGAA|CAACACGTCAGTTAGTTTTGGGAAATGCGG
CGATCACTTTCGTGAACCTCAAGTAGGAGT|ATGGTCTATCAGTTAGTACTGTGAATGGGT
ATGGGTGGAGCGGGTGGGCACGACGTACCC|TGATATATGTCGAGACCTTACTGTGAATGG
AAGGGCAAATATCACTGATCCTAACTGAGC|ACTGTGAATGGGTGGAGCGGGTGGGCACGC
GGGTGGAGCGGGTGGGCACGCACGCTGCAC|GGTGGGCACGAAAGTGGTTCTGGCGTCGTT
GGGCACGACGTTCTGTGGTCGGAGCTCAAG|GGTGCGGCTGTGTTCACACCTGTCTTTACT
GGGTGGGCACGACCGCACTGGCAATCCTTT|ATGGGTGGAGCGGGTGGGCACGCAATGGGC
CGAGATGCATCAGGGCAACACAAGATGCCG|TGAATGGGTGGAGCGGGTGGGCACGCTTGC
GGGCACTACTGTGAATGGGTGGAGCGGGTG|TGGAGCGGGTGGGCACGGCCCGAGCGCCCC
GAATGGGTGGAGCGGGTGGGCACGCAGATA|ACCGCACTGGCAATCCTTTCATATGGACGC
GGCATTTAATGACCTGATGAGTTTTATGTG|TCTCATCTTTGTGGAAGTTCCACGAGATGC
GGCACGGTGAATGGGTGGAGCGGGTGGGCA|TGAGGGGATGTGATATATGTCGAGACCTTA
GGTGGGCACGACGTACCCCGTGCTGCTCTA|AGACCTTACTGTGAATGGGTGGAGCGGGTG
AGCGCCCCGCGGAACAACTCCACATGCCCG|GTCAATTAGCGGAACGTCCTAAGCCTGCAG
GCGGGTGGGCACGACGTACCCCGTGCTGCT|TCGAGACCTTACTGTGAATGGGTGGAGCGG
TGTGAATGGGTGGAGCGGGTGGTACTGTGA|AAAGGACGGCCAATGATGGCAAGGATGTCG
ACACCTGTCTTTACTGTGAATGGGTGGAGC|TGGAGCGGGTGGGCACGACCGCACTGGCAA
GAACGTCCTAAGCCTGCAGTTTGCAGTGGG|GCGTATATGCGTGGAAGCGCGTCTACTCTT
GGCACGCTTGCGTCTTGACTCACAGAACCG|GGTACTGTGAATGGGTGGAGCGGGTGGGCA
AATGGGTGGAGCGGGTGGGCACGACGTTCT|GCCGGTCGTCTTTTTGGGTGCGGCTGTGTT
ATACTGTGAATGGGTGGAGCGGGTGGGCAC|GTATGCTGTCAGTACTGTGAATGGGTGGAG
GCTGTCAATTAGCGGAACGTCCTAAGCCTG|AGATAGGCTACTGTGCGTATATGCGTGGAA
TCACTTTCGTGAACCTCAAGTAGGAGTGAA|GTCTATCAGTTAGTACTGTGAATGGGTGGA
CGGGCATTTAATGACCTGATGAGTTTTATG|GATCTCATCTTTGTGGAAGTTCCACGAGAT
GTGAATGGGTGGAGCGGGTGGGCACGACGT|GATGTGATATATGTCGAGACCTTACTGTGA
GAAGCGCGTCTACTCTTAGTTAAATGGGAT|CACCGTGAGTACTGTGAATGGGTGGAGCGG
GCCCGAGCGCCCCGCGGAACAACTCCACAT|GCGCTGTCAATTAGCGGAACGTCCTAAGCC
CCCGGCCGGTCGTCTTTTTGGGTGCGGCTG|GGATCGGCTTTCTCACGGCTAATACTGTGA
ACGCAGATAGGCTACTGTGCGTATATGCGT|TATGGACGCCCACTCGACCCGGCGGGGACC
TTCGTGAACCTCAAGTAGGAGTGAAAAGGA|TCAGTTAGTACTGTGAATGGGTGGAGCGGG
TCACATGATCTCATCTTTGTGGAAGTTCCA|TGGCAGGTCGGGGTTCACTGGCCTGTACTG
AGCGGGTGGGCACGACTCGAACGTATGCTG|AGTTAGTTTTGGGAAATGCGGCTCAGGAAT
GGAGCGGGTGGGTACTGTGAATGGGTGGAG|CTTACTGTGAATGGGTGGAGCGGGTGGGCA
GAGCGGGTGGGCACGACCGCACTGGCAATC|GTGAATGGGTGGAGCGGGTGGGCACGCAAT
GGGATCGGCTTTCTCACGGCTAATACTGTG|AGCGGGTGGGCACGACTCGAACGTATGCTG
GGTGGTACTGTGAATGGGTGGAGCGGGTGG|GGCAAGGATGTCGTGTACTGTGAATGGGTG
TGTCAGTACTGTGAATGGGTGGAGCGGGTG|ATTGGTTCACTGGTCTCTTATAGGACTGGT
GAGATGCATCAGGGCAACACAAGATGCCGG|GAATGGGTGGAGCGGGTGGGCACGCTTGCG
GGTGGGCACTACTGTGAATGGGTGGAGCGG|GGGTGGAGCGGGTGGGCACGGCCCGAGCGC
AGACTACTTACTGTGAATGGGTGGAGCGGG|ACCGGGCATTTAATGACCTGATGAGTTTTA
GGGTGGAGCGGGTGGGCACGCAGATAGGCT|CACTGGCAATCCTTTCATATGGACGCCCAC
GGGCACGCTACACCCATGCGATCACTTTCG|ACAACTCCACATGCCCGTATGGTCTATCAG
ACGGCCCGAGCGCCCCGCGGAACAACTCCA|TGAGCGCTGTCAATTAGCGGAACGTCCTAA
CTGTAAATACCACGCTGTCGTCGAGGAGGA|GTGGAGCGGGTGGGCACGCACGCTGCACTC
CCGGAGACCGTCTGTATACAGCTTACTGTG|TGCGTCTTGACTCACAGAACCGTTAGTTGG
GTCTTGACTCACAGAACCGTTAGTTGGGCA|TGGGTGGAGCGGGTGGGCACTACTGTGAAT
CGGGTGGGCACGGGCACGCTACACCCATGC|CGCCCCGCGGAACAACTCCACATGCCCGTA
TGTCGAGACCTTACTGTGAATGGGTGGAGC|GATGCCGGAGACCGTCTGTATACAGCTTAC
GCTTCAACTGGTCGGATATAGACTACTTAC|GCTGTCGTCGAGGAGGAGCACCGGGCATTT
ATGGGTGGAGCGGGTGGGCACGACTCGAAC|AACACGTCAGTTAGTTTTGGGAAATGCGGC
ATGTGAGGGGATGTGATATATGTCGAGACC|GATGCATCAGGGCAACACAAGATGCCGGAG
CACCGGGCATTTAATGACCTGATGAGTTTT|CATGATCTCATCTTTGTGGAAGTTCCACGA
CCACGAGATGCATCAGGGCAACACAAGATG|CTGTGAATGGGTGGAGCGGGTGGGCACGCT
CGACTCGAACGTATGCTGTCAGTACTGTGA|GAAATGCGGCTCAGGAATTGGTTCACTGGT
GTGGGGGCCTAGGCCCCGGCCGGTCGTCTT|CTCTTAGTTAAATGGGATCGGCTTTCTCAC
GGGTGGGCACGCTTGCGTCTTGACTCACAG|CGGGTGGTACTGTGAATGGGTGGAGCGGGT
GACCCGGCGGGGACCACACCGTGAGTACTG|GCTCGTCCTGTCTCGTGTGGGATGTCGCTG
GTATACAGCTTACTGTGAATGGGTGGAGCG|ACAGAACCGTTAGTTGGGCACACGCAACTA
GGGTGGGCACGGTGAATGGGTGGAGCGGGT|TTATGTGAGGGGATGTGATATATGTCGAGA
GAGCACCGGGCATTTAATGACCTGATGAGT|TCACATGATCTCATCTTTGTGGAAGTTCCA
TTCGCATCTTACCAAATTCGAGTTAATAAG|CATGCGATCACTTTCGTGAACCTCAAGTAG
TCACTGGCCTGTACTGTGAATGGGTGGAGC|GTTAATAAGATGTACTGTGAATGGGTGGAG
AGCGGGTGGGCACGCACGCTGCACTCACAT|CACGAAAGTGGTTCTGGCGTCGTTTGGCAG
AGCGGGTGGGCACGACGTACCCCGTGCTGC|GTCGAGACCTTACTGTGAATGGGTGGAGCG
GGAGCGGGTGGGCACGCTTGCGTCTTGACT|TGGAGCGGGTGGTACTGTGAATGGGTGGAG
CCCGTATGGTCTATCAGTTAGTACTGTGAA|GCAGTTTGCAGTGGGGGCCTAGGCCCCGGC
GATCCTAACTGAGCGCTGTCAATTAGCGGA|GCGGGTGGGCACGCAGATAGGCTACTGTGC
AACACAAGATGCCGGAGACCGTCTGTATAC|GTGGGCACGCTTGCGTCTTGACTCACAGAA
TGCAGTGGGGGCCTAGGCCCCGGCCGGTCG|TCTACTCTTAGTTAAATGGGATCGGCTTTC
CCCCGCGGAACAACTCCACATGCCCGTATG|ATTAGCGGAACGTCCTAAGCCTGCAGTTTG
TACCACGCTGTCGTCGAGGAGGAGCACCGG|GGGTGGGCACGCACGCTGCACTCACATGAT
CTGTGAATGGGTGGAGCGGGTGGGCACGGT|TAATGACCTGATGAGTTTTATGTGAGGGGA
ATATATGTCGAGACCTTACTGTGAATGGGT|CACAAGATGCCGGAGACCGTCTGTATACAG
CACGAGATGCATCAGGGCAACACAAGATGC|TGTGAATGGGTGGAGCGGGTGGGCACGCTT
ATGGGTGGAGCGGGTGGGCACGAAAGTGGT|CACACGCAACTATGGACCAAACCATTCGCA
CCCCGTGCTGCTCTATCATGTAATTAACCC|TGGGTGGAGCGGGTGGGTACTGTGAATGGG
GAGTGAAAAGGACGGCCAATGATGGCAAGG|GGGTGGAGCGGGTGGGCACGACGTTCTGTG
TGGGCACGACGTACCCCGTGCTGCTCTATC|ACCTTACTGTGAATGGGTGGAGCGGGTGGG
AAGTTCCACGAGATGCATCAGGGCAACACA|CTGTACTGTGAATGGGTGGAGCGGGTGGGC
AAATTCGAGTTAATAAGATGTACTGTGAAT|TCGTGAACCTCAAGTAGGAGTGAAAAGGAC
ATTAACCCTGTAAATACCACGCTGTCGTCG|TGAATGGGTGGAGCGGGTGGGCACGCACGC
GGGCACGCAGATAGGCTACTGTGCGTATAT|TTCATATGGACGCCCACTCGACCCGGCGGG
TGAGGGGATGTGATATATGTCGAGACCTTA|GCATCAGGGCAACACAAGATGCCGGAGACC
TGGTCGGAGCTCAAGGGCAAATATCACTGA|ACACCTGTCTTTACTGTGAATGGGTGGAGC
AATGGGTGGAGCGGGTGGGTACTGTGAATG|TATACAGCTTACTGTGAATGGGTGGAGCGG
GTGAATGGGTGGAGCGGGTGGGCACTACTG|GTCGTGTACTGTGAATGGGTGGAGCGGGTG
TGAATGGGTGGAGCGGGTGGTACTGTGAAT|AGGACGGCCAATGATGGCAAGGATGTCGTG
GGCTACTGTGCGTATATGCGTGGAAGCGCG|CCACTCGACCCGGCGGGGACCACACCGTGA
TGGGCACGACGTTCTGTGGTCGGAGCTCAA|GGGTGCGGCTGTGTTCACACCTGTCTTTAC
GAACAACTCCACATGCCCGTATGGTCTATC|GAACGTCCTAAGCCTGCAGTTTGCAGTGGG
CTGAGCGCTGTCAATTAGCGGAACGTCCTA|GCACGCAGATAGGCTACTGTGCGTATATGC
GGGGGCCTAGGCCCCGGCCGGTCGTCTTTT|CTTAGTTAAATGGGATCGGCTTTCTCACGG
GAGCGGGTGGGCACGACGTACCCCGTGCTG|TGTCGAGACCTTACTGTGAATGGGTGGAGC
GGGTGGAGCGGGTGGGCACTACTGTGAATG|TACTGTGAATGGGTGGAGCGGGTGGGCACG
TGGGCACACGCAACTATGGACCAAACCATT|GTGAATGGGTGGAGCGGGTGGGCACGGGCA
CACGACCGCACTGGCAATCCTTTCATATGG|GAGCGGGTGGGCACGCAATGGGCGAATGTG
AACCGTTAGTTGGGCACACGCAACTATGGA|GGGCACTACTGTGAATGGGTGGAGCGGGTG
CTCGAACGTATGCTGTCAGTACTGTGAATG|ATGCGGCTCAGGAATTGGTTCACTGGTCTC
TGCTCTATCATGTAATTAACCCTGTAAATA|GCGGGTGGGTACTGTGAATGGGTGGAGCGG
GCCCCGGCCGGTCGTCTTTTTGGGTGCGGC|TGGGATCGGCTTTCTCACGGCTAATACTGT
CGGCCGGTCGTCTTTTTGGGTGCGGCTGTG|ATCGGCTTTCTCACGGCTAATACTGTGAAT
CGGGTGGGCACGGCCCGAGCGCCCCGCGGA|GATCCTAACTGAGCGCTGTCAATTAGCGGA
ACCACACCGTGAGTACTGTGAATGGGTGGA|TCGTGTGGGATGTCGCTGAGCAACACGTCA
AGCCTTTTCCGAAATTAAATACAGTTGTGG|GTGGGCACGACGTACCCCGTGCTGCTCTAT
TACCCCGTGCTGCTCTATCATGTAATTAAC|AATGGGTGGAGCGGGTGGGTACTGTGAATG
ACATGATCTCATCTTTGTGGAAGTTCCACG|GCAGGTCGGGGTTCACTGGCCTGTACTGTG
CTTGACTCACAGAACCGTTAGTTGGGCACA|GGTGGAGCGGGTGGGCACTACTGTGAATGG
TTTTGGGTGCGGCTGTGTTCACACCTGTCT|CGGCTAATACTGTGAATGGGTGGAGCGGGT
CGGCTGTGTTCACACCTGTCTTTACTGTGA|CTGTGAATGGGTGGAGCGGGTGGGCACGAC
CCTGCAGTTTGCAGTGGGGGCCTAGGCCCC|GGAAGCGCGTCTACTCTTAGTTAAATGGGA
TGGGTGGAGCGGGTGGGCACGCTTGCGTCT|ATGGGTGGAGCGGGTGGTACTGTGAATGGG
TTCTGTGGTCGGAGCTCAAGGGCAAATATC|TGTTCACACCTGTCTTTACTGTGAATGGGT
CGGGCACGCTACACCCATGCGATCACTTTC|AACAACTCCACATGCCCGTATGGTCTATCA
AACCCTGTAAATACCACGCTGTCGTCGAGG|ATGGGTGGAGCGGGTGGGCACGCACGCTGC
CATCAGGGCAACACAAGATGCCGGAGACCG|GTGGAGCGGGTGGGCACGCTTGCGTCTTGA
ACTGTGAATGGGTGGAGCGGGTGGGCACGG|TTAATGACCTGATGAGTTTTATGTGAGGGG
CTGTGAATGGGTGGAGCGGGTGGGCACGAC|CTGAGCAACACGTCAGTTAGTTTTGGGAAA
GTGAATGGGTGGAGCGGGTGGTACTGTGAA|AAGGACGGCCAATGATGGCAAGGATGTCGT
AGCGGGTGGGCACGGGCACGCTACACCCAT|AGCGCCCCGCGGAACAACTCCACATGCCCG
AATGGGTGGAGCGGGTGGGCACGGGCACGC|CACGGCCCGAGCGCCCCGCGGAACAACTCC
GCACGCAGATAGGCTACTGTGCGTATATGC|CATATGGACGCCCACTCGACCCGGCGGGGA
CAGTTAGTACTGTGAATGGGTGGAGCGGGT|GGGCCTAGGCCCCGGCCGGTCGTCTTTTTG
GGTACTGTGAATGGGTGGAGCGGGTGGGCA|AAGGATGTCGTGTACTGTGAATGGGTGGAG
GTGGGTACTGTGAATGGGTGGAGCGGGTGG|TGAATGGGTGGAGCGGGTGGGCACGAAAGT
CAAATATCACTGATCCTAACTGAGCGCTGT|GAATGGGTGGAGCGGGTGGGCACGCAGATA
TGAATGGGTGGAGCGGGTGGGCACGGTGAA|TGACCTGATGAGTTTTATGTGAGGGGATGT
GAATGGGTGGAGCGGGTGGGCACGACGTTC|GGCCGGTCGTCTTTTTGGGTGCGGCTGTGT
ACGACCGCACTGGCAATCCTTTCATATGGA|AGCGGGTGGGCACGCAATGGGCGAATGTGT
ACTTTCGTGAACCTCAAGTAGGAGTGAAAA|CTATCAGTTAGTACTGTGAATGGGTGGAGC
TGCGTGGAAGCGCGTCTACTCTTAGTTAAA|GGACCACACCGTGAGTACTGTGAATGGGTG
TGAATGGGTGGAGCGGGTGGGTACTGTGAA|TGTATACAGCTTACTGTGAATGGGTGGAGC
GACCGCACTGGCAATCCTTTCATATGGACG|CGGGTGGGCACGCAATGGGCGAATGTGTTA
GGGTGGGCACGACTCGAACGTATGCTGTCA|TAGTTTTGGGAAATGCGGCTCAGGAATTGG
GTGAATGGGTGGAGCGGGTGGGCACGACCG|CTGTCAGTACTGTGAATGGGTGGAGCGGGT
GGTGGAGCGGGTGGGCACGACGTTCTGTGG|GTCGTCTTTTTGGGTGCGGCTGTGTTCACA
TCGAGTTAATAAGATGTACTGTGAATGGGT|GAACCTCAAGTAGGAGTGAAAAGGACGGCC
CACTACTGTGAATGGGTGGAGCGGGTGGGC|AGCGGGTGGGCACGGCCCGAGCGCCCCGCG
CCGTTAGTTGGGCACACGCAACTATGGACC|GCACTACTGTGAATGGGTGGAGCGGGTGGG
AGATAGGCTACTGTGCGTATATGCGTGGAA|GACGCCCACTCGACCCGGCGGGGACCACAC
CCAAGCTGGGCTTCAACTGGTCGGATATAG|AAATACCACGCTGTCGTCGAGGAGGAGCAC
GTGGAGCGGGTGGGCACGGTGAATGGGTGG|ATGAGTTTTATGTGAGGGGATGTGATATAT
CGTTCTGTGGTCGGAGCTCAAGGGCAAATA|TGTGTTCACACCTGTCTTTACTGTGAATGG
GTTAGTACTGTGAATGGGTGGAGCGGGTGG|GCCTAGGCCCCGGCCGGTCGTCTTTTTGGG
ACGCTACACCCATGCGATCACTTTCGTGAA|CTCCACATGCCCGTATGGTCTATCAGTTAG
TGTGAATGGGTGGAGCGGGTGGGCACGGGC|TGGGCACGGCCCGAGCGCCCCGCGGAACAA
TGTGTTCACACCTGTCTTTACTGTGAATGG|GAATGGGTGGAGCGGGTGGGCACGACCGCA
CACACCTGTCTTTACTGTGAATGGGTGGAG|GTGGAGCGGGTGGGCACGACCGCACTGGCA
AGTAGGAGTGAAAAGGACGGCCAATGATGG|TGAATGGGTGGAGCGGGTGGGCACGACGTT
CCGTGCTGCTCTATCATGTAATTAACCCTG|GGTGGAGCGGGTGGGTACTGTGAATGGGTG
AGTACTGTGAATGGGTGGAGCGGGTGGGCA|TAGGCCCCGGCCGGTCGTCTTTTTGGGTGC
GCAGTTTTTTCGCATCTTACCAAATTCGAG|GCTACACCCATGCGATCACTTTCGTGAACC
GCGATCACTTTCGTGAACCTCAAGTAGGAG|TATGGTCTATCAGTTAGTACTGTGAATGGG
TGTGAATGGGTGGAGCGGGTGGGCACGACT|TGAGCAACACGTCAGTTAGTTTTGGGAAAT
CGCTGTCAATTAGCGGAACGTCCTAAGCCT|CAGATAGGCTACTGTGCGTATATGCGTGGA
CTTACTGTGAATGGGTGGAGCGGGTGGGCA|GTTAGTTGGGCACACGCAACTATGGACCAA
GTGGAGCGGGTGGGCACGCTTGCGTCTTGA|GGTGGAGCGGGTGGTACTGTGAATGGGTGG
AATGGGTGGAGCGGGTGGGCACGAAAGTGG|GCACACGCAACTATGGACCAAACCATTCGC
GCGGGTGGGCACGACGTTCTGTGGTCGGAG|TTTTTGGGTGCGGCTGTGTTCACACCTGTC
TCTCACGGCTAATACTGTGAATGGGTGGAG|ACGACTCGAACGTATGCTGTCAGTACTGTG
TGGAGCGGGTGGGCACGCAGATAGGCTACT|TGGCAATCCTTTCATATGGACGCCCACTCG
CTTGCGTCTTGACTCACAGAACCGTTAGTT|GTGAATGGGTGGAGCGGGTGGGCACTACTG
GGTCGGGGTTCACTGGCCTGTACTGTGAAT|CAAATTCGAGTTAATAAGATGTACTGTGAA
CACAAGATGCCGGAGACCGTCTGTATACAG|GGGCACGCTTGCGTCTTGACTCACAGAACC
CTGCTCTATCATGTAATTAACCCTGTAAAT|AGCGGGTGGGTACTGTGAATGGGTGGAGCG
GGAGCGGGTGGGCACGCAGATAGGCTACTG|GGCAATCCTTTCATATGGACGCCCACTCGA
GTATGCTGTCAGTACTGTGAATGGGTGGAG|TCAGGAATTGGTTCACTGGTCTCTTATAGG
CCCCGGCCGGTCGTCTTTTTGGGTGCGGCT|GGGATCGGCTTTCTCACGGCTAATACTGTG
GAGGAGCACCGGGCATTTAATGACCTGATG|CACTCACATGATCTCATCTTTGTGGAAGTT
CAGAACCGTTAGTTGGGCACACGCAACTAT|GGTGGGCACTACTGTGAATGGGTGGAGCGG
AGGAGGAGCACCGGGCATTTAATGACCTGA|TGCACTCACATGATCTCATCTTTGTGGAAG
GGTGGGCACGGTGAATGGGTGGAGCGGGTG|TATGTGAGGGGATGTGATATATGTCGAGAC
TTTTCGCATCTTACCAAATTCGAGTTAATA|CCCATGCGATCACTTTCGTGAACCTCAAGT
TACACCCATGCGATCACTTTCGTGAACCTC|ACATGCCCGTATGGTCTATCAGTTAGTACT
CGGAACAACTCCACATGCCCGTATGGTCTA|CGGAACGTCCTAAGCCTGCAGTTTGCAGTG
GCCGGTCGTCTTTTTGGGTGCGGCTGTGTT|CGGCTTTCTCACGGCTAATACTGTGAATGG
GACCTGATGAGTTTTATGTGAGGGGATGTG|GTGGAAGTTCCACGAGATGCATCAGGGCAA
GTGGAGCGGGTGGGCACGCAGATAGGCTAC|CTGGCAATCCTTTCATATGGACGCCCACTC
CACCCATGCGATCACTTTCGTGAACCTCAA|ATGCCCGTATGGTCTATCAGTTAGTACTGT
ACCGCACTGGCAATCCTTTCATATGGACGC|GGGTGGGCACGCAATGGGCGAATGTGTTAC
GGGTGGGCACGAAAGTGGTTCTGGCGTCGT|ATGGACCAAACCATTCGCAGTTTTTTCGCA
TGGGCACGCAGATAGGCTACTGTGCGTATA|TTTCATATGGACGCCCACTCGACCCGGCGG
TATGCGTGGAAGCGCGTCTACTCTTAGTTA|GGGGACCACACCGTGAGTACTGTGAATGGG
CGCAGTTTTTTCGCATCTTACCAAATTCGA|CGCTACACCCATGCGATCACTTTCGTGAAC
CGGTCGTCTTTTTGGGTGCGGCTGTGTTCA|GCTTTCTCACGGCTAATACTGTGAATGGGT
ACTGTGAATGGGTGGAGCGGGTGGGCACGA|GCTGAGCAACACGTCAGTTAGTTTTGGGAA
GCTACACCCATGCGATCACTTTCGTGAACC|CCACATGCCCGTATGGTCTATCAGTTAGTA
ACAGAACCGTTAGTTGGGCACACGCAACTA|GGGTGGGCACTACTGTGAATGGGTGGAGCG
GGTGGAGCGGGTGGGCACGACCGCACTGGC|TACTGTGAATGGGTGGAGCGGGTGGGCACG
AGTTAATAAGATGTACTGTGAATGGGTGGA|CCTCAAGTAGGAGTGAAAAGGACGGCCAAT
CTGTGAATGGGTGGAGCGGGTGGGCACGAA|GTTGGGCACACGCAACTATGGACCAAACCA
CTAAGCCTGCAGTTTGCAGTGGGGGCCTAG|TGCGTGGAAGCGCGTCTACTCTTAGTTAAA
CACGCACGCTGCACTCACATGATCTCATCT|GTTCTGGCGTCGTTTGGCAGGTCGGGGTTC
TGCCGGAGACCGTCTGTATACAGCTTACTG|CTTGCGTCTTGACTCACAGAACCGTTAGTT
GGACCACACCGTGAGTACTGTGAATGGGTG|TCTCGTGTGGGATGTCGCTGAGCAACACGT
TGGAGCGGGTGGGCACTACTGTGAATGGGT|TGTGAATGGGTGGAGCGGGTGGGCACGGCC
CGGGGACCACACCGTGAGTACTGTGAATGG|CTGTCTCGTGTGGGATGTCGCTGAGCAACA
TATATGCGTGGAAGCGCGTCTACTCTTAGT|GCGGGGACCACACCGTGAGTACTGTGAATG
TAGGCCCCGGCCGGTCGTCTTTTTGGGTGC|AAATGGGATCGGCTTTCTCACGGCTAATAC
TTCGAGTTAATAAGATGTACTGTGAATGGG|TGAACCTCAAGTAGGAGTGAAAAGGACGGC
GGAGCGGGTGGGCACGACCGCACTGGCAAT|TGTGAATGGGTGGAGCGGGTGGGCACGCAA
GACCGTCTGTATACAGCTTACTGTGAATGG|CTTGACTCACAGAACCGTTAGTTGGGCACA
CCCTGTAAATACCACGCTGTCGTCGAGGAG|GGGTGGAGCGGGTGGGCACGCACGCTGCAC
ATGGGATCGGCTTTCTCACGGCTAATACTG|GGAGCGGGTGGGCACGACTCGAACGTATGC
CACACCGTGAGTACTGTGAATGGGTGGAGC|GTGTGGGATGTCGCTGAGCAACACGTCAGT
CTGTGAATGGGTGGAGCGGGTGGGTACTGT|GTCTGTATACAGCTTACTGTGAATGGGTGG
GGATCGGCTTTCTCACGGCTAATACTGTGA|GCGGGTGGGCACGACTCGAACGTATGCTGT
TTCCGAAATTAAATACAGTTGTGGCCAGAC|ACGACGTACCCCGTGCTGCTCTATCATGTA
TGGAAGTTCCACGAGATGCATCAGGGCAAC|GGCCTGTACTGTGAATGGGTGGAGCGGGTG
AGCGGGTGGGCACGCTTGCGTCTTGACTCA|GAGCGGGTGGTACTGTGAATGGGTGGAGCG
AATCCTTTCATATGGACGCCCACTCGACCC|CAATGGGCGAATGTGTTACATAATAGCTCG
AATGATGGCAAGGATGTCGTGTACTGTGAA|ACGACGTTCTGTGGTCGGAGCTCAAGGGCA
TGATATATGTCGAGACCTTACTGTGAATGG|AACACAAGATGCCGGAGACCGTCTGTATAC
GGGTGGAGCGGGTGGTACTGTGAATGGGTG|GGCCAATGATGGCAAGGATGTCGTGTACTG
ACTATGGACCAAACCATTCGCAGTTTTTTC|AGCGGGTGGGCACGGGCACGCTACACCCAT
TATCACTGATCCTAACTGAGCGCTGTCAAT|GGGTGGAGCGGGTGGGCACGCAGATAGGCT
TGTCGTGTACTGTGAATGGGTGGAGCGGGT|TCGGAGCTCAAGGGCAAATATCACTGATCC
GTGGAGCGGGTGGGCACGCACGCTGCACTC|TGGGCACGAAAGTGGTTCTGGCGTCGTTTG
CGGCTAATACTGTGAATGGGTGGAGCGGGT|TCGAACGTATGCTGTCAGTACTGTGAATGG
TACTGTGAATGGGTGGAGCGGGTGGGCACG|TCAAGGGCAAATATCACTGATCCTAACTGA
GTTAGTTGGGCACACGCAACTATGGACCAA|ACTACTGTGAATGGGTGGAGCGGGTGGGCA
TGGGTGGAGCGGGTGGGCACGACGTTCTGT|CGGTCGTCTTTTTGGGTGCGGCTGTGTTCA
TCCTTTCATATGGACGCCCACTCGACCCGG|ATGGGCGAATGTGTTACATAATAGCTCGTC
CACTGGCAATCCTTTCATATGGACGCCCAC|GGGCACGCAATGGGCGAATGTGTTACATAA
ACTGTGAATGGGTGGAGCGGGTGGGCACGC|GCACGACCGCACTGGCAATCCTTTCATATG
TCACACCTGTCTTTACTGTGAATGGGTGGA|GGTGGAGCGGGTGGGCACGACCGCACTGGC
CACTCGACCCGGCGGGGACCACACCGTGAG|TAATAGCTCGTCCTGTCTCGTGTGGGATGT
GATATATGTCGAGACCTTACTGTGAATGGG|ACACAAGATGCCGGAGACCGTCTGTATACA
ATGGGTGGAGCGGGTGGGCACGCTTGCGTC|AATGGGTGGAGCGGGTGGTACTGTGAATGG
AATGGGTGGAGCGGGTGGGCACGCACGCTG|GCGGGTGGGCACGAAAGTGGTTCTGGCGTC
AGCGGGTGGGCACGAAAGTGGTTCTGGCGT|ACTATGGACCAAACCATTCGCAGTTTTTTC
TAGTACTGTGAATGGGTGGAGCGGGTGGGC|CTAGGCCCCGGCCGGTCGTCTTTTTGGGTG
CGGCTTTCTCACGGCTAATACTGTGAATGG|GTGGGCACGACTCGAACGTATGCTGTCAGT
TATAGACTACTTACTGTGAATGGGTGGAGC|AGCACCGGGCATTTAATGACCTGATGAGTT
TTGTGGAAGTTCCACGAGATGCATCAGGGC|ACTGGCCTGTACTGTGAATGGGTGGAGCGG
TCATCTTTGTGGAAGTTCCACGAGATGCAT|GGGTTCACTGGCCTGTACTGTGAATGGGTG
CGTATGGTCTATCAGTTAGTACTGTGAATG|AGTTTGCAGTGGGGGCCTAGGCCCCGGCCG
AGTGAAAAGGACGGCCAATGATGGCAAGGA|GGTGGAGCGGGTGGGCACGACGTTCTGTGG
TGGGCACGGCCCGAGCGCCCCGCGGAACAA|CTAACTGAGCGCTGTCAATTAGCGGAACGT
ACGACGTACCCCGTGCTGCTCTATCATGTA|ACTGTGAATGGGTGGAGCGGGTGGGTACTG
AATACAGTTGTGGCCAGACCCAAAACACTC|CGTGCTGCTCTATCATGTAATTAACCCTGT
GCGGGTGGTACTGTGAATGGGTGGAGCGGG|GATGGCAAGGATGTCGTGTACTGTGAATGG
CCGCGGAACAACTCCACATGCCCGTATGGT|TAGCGGAACGTCCTAAGCCTGCAGTTTGCA
GTCGGGGTTCACTGGCCTGTACTGTGAATG|AAATTCGAGTTAATAAGATGTACTGTGAAT
GTGGGCACGCACGCTGCACTCACATGATCT|AAGTGGTTCTGGCGTCGTTTGGCAGGTCGG
TGTAATTAACCCTGTAAATACCACGCTGTC|ACTGTGAATGGGTGGAGCGGGTGGGCACGC
CGAGCGCCCCGCGGAACAACTCCACATGCC|CTGTCAATTAGCGGAACGTCCTAAGCCTGC
TGGTCGGATATAGACTACTTACTGTGAATG|CGAGGAGGAGCACCGGGCATTTAATGACCT
ATGAGTTTTATGTGAGGGGATGTGATATAT|GTTCCACGAGATGCATCAGGGCAACACAAG
AAGCGCGTCTACTCTTAGTTAAATGGGATC|ACCGTGAGTACTGTGAATGGGTGGAGCGGG
ACGGTGAATGGGTGGAGCGGGTGGGCACGA|GGGGATGTGATATATGTCGAGACCTTACTG
GTGTACTGTGAATGGGTGGAGCGGGTGGGC|AGCTCAAGGGCAAATATCACTGATCCTAAC
TACTGTGAATGGGTGGAGCGGGTGGGCACG|GTACTGTGAATGGGTGGAGCGGGTGGTACT
GTGGAGCGGGTGGGCACGGGCACGCTACAC|CCCGAGCGCCCCGCGGAACAACTCCACATG
CGTTAGTTGGGCACACGCAACTATGGACCA|CACTACTGTGAATGGGTGGAGCGGGTGGGC
GGTGGAGCGGGTGGGCACGCACGCTGCACT|GTGGGCACGAAAGTGGTTCTGGCGTCGTTT
GCGGGTGGGCACGCAGATAGGCTACTGTGC|AATCCTTTCATATGGACGCCCACTCGACCC
TGTCAATTAGCGGAACGTCCTAAGCCTGCA|ATAGGCTACTGTGCGTATATGCGTGGAAGC
ATGGGTGGAGCGGGTGGGCACGGTGAATGG|CCTGATGAGTTTTATGTGAGGGGATGTGAT
CGACGTTCTGTGGTCGGAGCTCAAGGGCAA|GGCTGTGTTCACACCTGTCTTTACTGTGAA
TATCAGTTAGTACTGTGAATGGGTGGAGCG|TGGGGGCCTAGGCCCCGGCCGGTCGTCTTT
GCGGCTGTGTTCACACCTGTCTTTACTGTG|ACTGTGAATGGGTGGAGCGGGTGGGCACGA
TTGCGTCTTGACTCACAGAACCGTTAGTTG|TGAATGGGTGGAGCGGGTGGGCACTACTGT
AATTAGCGGAACGTCCTAAGCCTGCAGTTT|GCTACTGTGCGTATATGCGTGGAAGCGCGT
GCACTACTGTGAATGGGTGGAGCGGGTGGG|GAGCGGGTGGGCACGGCCCGAGCGCCCCGC
ACGGCCAATGATGGCAAGGATGTCGTGTAC|GTGGGCACGACGTTCTGTGGTCGGAGCTCA
GTGGAAGTTCCACGAGATGCATCAGGGCAA|TGGCCTGTACTGTGAATGGGTGGAGCGGGT
CGGGTGGGCACGACGTTCTGTGGTCGGAGC|TTTTGGGTGCGGCTGTGTTCACACCTGTCT
GGCGGGGACCACACCGTGAGTACTGTGAAT|TCCTGTCTCGTGTGGGATGTCGCTGAGCAA
TGGGGGCCTAGGCCCCGGCCGGTCGTCTTT|TCTTAGTTAAATGGGATCGGCTTTCTCACG
TTTCATATGGACGCCCACTCGACCCGGCGG|GGCGAATGTGTTACATAATAGCTCGTCCTG
GGGCACGCACGCTGCACTCACATGATCTCA|GTGGTTCTGGCGTCGTTTGGCAGGTCGGGG
AGGGCAACACAAGATGCCGGAGACCGTCTG|AGCGGGTGGGCACGCTTGCGTCTTGACTCA
ATTTAATGACCTGATGAGTTTTATGTGAGG|CATCTTTGTGGAAGTTCCACGAGATGCATC
TCGCATCTTACCAAATTCGAGTTAATAAGA|ATGCGATCACTTTCGTGAACCTCAAGTAGG
CGGAGCTCAAGGGCAAATATCACTGATCCT|CTGTCTTTACTGTGAATGGGTGGAGCGGGT
GGGTGGTACTGTGAATGGGTGGAGCGGGTG|TGGCAAGGATGTCGTGTACTGTGAATGGGT
CCAGACCCAAAACACTCCCAAGCTGGGCTT|CATGTAATTAACCCTGTAAATACCACGCTG
AGCCTGCAGTTTGCAGTGGGGGCCTAGGCC|GTGGAAGCGCGTCTACTCTTAGTTAAATGG
TAAGCCTTTTCCGAAATTAAATACAGTTGT|GGGTGGGCACGACGTACCCCGTGCTGCTCT
TGTGCGTATATGCGTGGAAGCGCGTCTACT|GACCCGGCGGGGACCACACCGTGAGTACTG
CAAGATGCCGGAGACCGTCTGTATACAGCT|GCACGCTTGCGTCTTGACTCACAGAACCGT
GCAGTGGGGGCCTAGGCCCCGGCCGGTCGT|CTACTCTTAGTTAAATGGGATCGGCTTTCT
GATGTCGTGTACTGTGAATGGGTGGAGCGG|GGTCGGAGCTCAAGGGCAAATATCACTGAT
TCATATGGACGCCCACTCGACCCGGCGGGG|CGAATGTGTTACATAATAGCTCGTCCTGTC
TGGGCACGCTTGCGTCTTGACTCACAGAAC|GTGGTACTGTGAATGGGTGGAGCGGGTGGG
GGAGCGGGTGGGCACGCACGCTGCACTCAC|GGCACGAAAGTGGTTCTGGCGTCGTTTGGC
GGGTGCGGCTGTGTTCACACCTGTCTTTAC|TAATACTGTGAATGGGTGGAGCGGGTGGGC
